Despite Tfl's best efforts, you've made it to Russell square tube station in one piece and only slightly behind schedule. You're a short walk away from the Developer Happiness Days event or Dev8D as it is usually known. It's taking place in the University of London Union (ULU) building and, if it is anything like it was last year, it will not only be great fun, but you'll meet lots of new people who you really want to meet but don't know it yet, you'll be introduced to new, potentially unknown and exciting software and even learn a few fresh tricks about dealing with the software you are already using.

You walk out from Russell Square station, pull up your phone and load up the directions to the ULU entrance. You walk along for a few minutes, staring down, tracking your progress with your phone. It isn't long before you approach the front door and have to pass by the throng of Smoking students to walk inside.

Dev8D
A day at Dev8D by Ben O'Steen
Release 1 / Serial number 120129 / Inform 7 build 6G60 (I6/v6.32 lib 6/12N) SD

ULU Entrance
You look around the foyer, scanning across the faces of the various students sat, engrossed in their laptops. You notice a small A4 sign for Dev8D on the north wall. To the west is a snack shop, selling all sorts of sweets, sandwiches and hot drinks. At least, it would be if it were open. There is a small lift to the north, but that is being used to take boxes of drinks upstairs. A lot of drinks.

You see an unmanned trestle table sagging with the weight of a huge pile - no, a mountain - of flyers, the lower reaches of which are decorated with toy figures. Someone has attempted to make the table and everything on it look old and dusty, but with the handicap of using only glitter, tinsel and coloured paper.

An old lamp sits nestled within a valley of paper. Unlike most of the other items on the table, the lamp looks old simply because it is. For some reason, a slightly warped plastic arrow is also on the table, positioned as if it is important. There is a red fish almost buried in glitter next to it on the table. Why someone would use so much glitter isn't obvious, unless they are doing it as a (thinly-veiled) cry for help. A shiny red keycard pokes out from underneath the fish. You note that it has somehow remained glitter-free.

You can see a dusty table (on which is a pile of flyers) here.

Exits: north.

>n
Ground floor stairs
In the low-light of the stairwell, you see a set of sharp-angled stairs spiralling upwards, fenced in by a utilitarian handrail, supported by thin banisters. The parts of the walls you can see are the kind of beige colour that cannot be described accurately without the words "institutional" and "depressing". It won't be how the colour is officially labelled, but labels are rarely honest. The noise from the rest of the building provides a background hum of activity. 

The only way is UP! (or something like that.) 

There is a message board lining the walls of the stairwell.

Exits: up and south to ULU Entrance.

>go up
Stairwell 1F
STAIRWELL 1F DESC.

>go down
Stairwell G
STAIRWELL G DESC.

>go up stairs
I only understood you as far as wanting to go up.

>where am I
That's not a verb I recognise.

* * *

>u
First floor stairs
A spiralling staircase, hemmed in by harsh railings and beige walls. The noise from the rest of the building provides a background hum of activity.

You see that the Gallery bar is north through the double doors, but now is no time to take a drink. You can go down to the ground floor or up a few flights to the third floor, which is where most of Dev8D will take place.

Exits: down to Ground floor stairs, up, north and south.

>u
Third floor stairs
A spiralling staircase, hemmed in by harsh railings and beige walls. The noise from the rest of the building provides a background hum of activity.

Exits: south and down to First floor stairs.

>s
Corridor - Middle
You turn left into a small open area alongside a beige-coloured corridor, the same disappointing shade as that used in the stairwell. There is a busy woman sat behind a cluttered desk. To the south you can see the doors to rooms 3C and 3D.  The corridor continues east towards a set of closed doors, and west, towards what sounds like the rest of the conference.

You can see a busy woman here.

Exits: east, west, north to Third floor stairs, southeast and southwest.

You can hear a murmur coming from the west. It sounds like everyone is down that way You'd better hurry.

>open 3d
You can't see any such thing.

>open door to 3D
You can't see any such thing.

>open 3C
You can't see any such thing.

>go through
What do you want to go through?

>go through 3C
You can't see any such thing.

>sw
3D
ROOM GENERIC DESCRIPTION.

>n
Corridor - Middle
REGISTRATION DESK CORRIDOR.

>go 3D
You can't see any such thing.

>go to 3D
You can't see any such thing.

>enter 3D
You can't see any such thing.

>go into room 3D
You can't see any such thing.

* * *

>s
Corridor - Middle
You turn left into a small open area alongside a beige-coloured corridor, the same disappointing shade as that used in the stairwell. There is a busy woman sat behind a cluttered desk. To the south you can see the doors to rooms 3C and 3D.  The corridor continues east towards a set of closed doors, and west, towards what sounds like the rest of the conference.

You can see a busy woman here.

Exits: east, west, north to Third floor stairs, southeast and southwest.

You can hear a murmur coming from the west. It sounds like everyone is down that way You'd better hurry.

>examine 3D door window
Through the 3D door, you can see...

>examine 3D
Through the 3D door, you can see...

>look 3D
Through the 3D door, you can see...

>look at 3D
Through the 3D door, you can see...

* * *

>s
Corridor - Middle
You turn left into a small open area alongside a beige-coloured corridor, the same disappointing shade as that used in the stairwell. There is a busy woman sat behind a cluttered desk. To the south you can see the doors to rooms 3C and 3D.  The corridor continues east towards a set of closed doors, and west, towards what sounds like the rest of the conference.

You can see a busy woman here.

Exits: east, west, north to Third floor stairs, southeast and southwest.

You can hear a murmur coming from the west. It sounds like everyone is down that way You'd better hurry.

>e
Corridor - East
corridor east.

Exits: west to Corridor - Middle, southeast and southwest.

>look 3A
 Getting Ready

* * *

>e
Corridor - East
corridor east.

Exits: west to Corridor - Middle, southeast and southwest.

>e
You can't go that way.

>w
Corridor - Middle
REGISTRATION DESK CORRIDOR.

You can see a helpful woman here.

Exits: west, north to Third floor stairs, southeast, southwest and east to Corridor - East.

>w
Corridor - West
corridor west.

Exits: east to Corridor - Middle, west and south.

>w
Corridor - Westmost
BASECAMP CORRIDOR.

Exits: east to Corridor - West and north.

>n
Basecamp

Exits: south to Corridor - Westmost.

You enter the door and come face-to-face (well, face-to-back) with a crowd of people, all of whom are looking intently towards the other side of the room. It seems that things are just about to start, so you press forward to get a decent enough view. You manoeuvre through the throng of developers, hackers, academics and other delegates as politely as you can until you manage to get a view of the organiser who is just about to speak.

"Welcome! Thank you all for coming to this, the fourth Dev8D! Yes, fourth! I'm so glad to see lots of new faces out there, standing amongst the faces I already know well! You know, helping people meet up and talk about the things that interest or even stump you is one of the key reasons this event exists. Many of you work in small teams and can feel isolated. Sometimes you alone are the team!"

You hear quite a few knowing laughs from the people in the crowd. Seems you aren't alone here after all.

>z
Time passes.

He continues: "

>z
Time passes.

If you haven't yet registered and picked up your Dev8D lanyard, please do so as soon as you can - it has your name on it!

>z
Time passes.

>s
Corridor - Westmost
BASECAMP CORRIDOR.

Exits: east to Corridor - West and north to Basecamp.

>e
Corridor - West
corridor west.

Exits: east to Corridor - Middle, west to Corridor - Westmost and south.

>e
Corridor - Middle
REGISTRATION DESK CORRIDOR.

You can see a helpful woman here.

Exits: west to Corridor - West, north to Third floor stairs, southeast, southwest and east to Corridor - East.

>n
Third floor stairs
A spiralling staircase, hemmed in by harsh railings and beige walls. The noise from the rest of the building provides a background hum of activity.

Exits: south to Corridor - Middle and down to First floor stairs.

>d
First floor stairs
A spiralling staircase, hemmed in by harsh railings and beige walls. The noise from the rest of the building provides a background hum of activity.

You see that the Gallery bar is north through the double doors. You can go down to the ground floor or up a few flights to the third floor.

Exits: down to Ground floor stairs, up to Third floor stairs, north and south.

>d
Ground floor stairs
A spiralling staircase, hemmed in by harsh railings and beige walls. The noise from the rest of the building provides a background hum of activity. 

The only way is UP! or something like that. 

There is a message board lining the walls of the stairwell.

Exits: south to ULU Entrance and up to First floor stairs.

>s
ULU Entrance
The shop is still closed it seems and the Sisyphean challenge of keeping the bar stocked with booze and J20 is still ongoing. Students are still quietly working and chatting in the seated area.

You see a flimsy, trestle table - weighed down with a pile of retro-game flyers - that someone has attempted to make look dusty and old with the handicap of using only glitter, tinsel and coloured paper.

Perched amongst the flyers, you see an old lamp. For some reason, a slightly warped plastic arrow is also on the table. You also spot a red fish sprinkled with glitter. It is not obvious why someone has done this unless it's a desperate cry for help. A shiny red keycard is poking out from underneath the fish.

Exits: north to Ground floor stairs.

>rub lamp
Rubbing the old lamp is not particularly rewarding. Anyway, nothing exciting happens (aside from your hands getting covered in fake spider web, but you tried, and that's the main thing!)

[Your score has just gone up by one point.]

>rub lamp
Rub me once, get a point for free. Rub me twice, no more points for you. Greedy.

>test lamp
(Testing.)

>[1] x lamp
It looks like an old Davy lamp, covered with joke-shop cobwebs and glitter.

>[2] x lamp
 It looks like it hasn't been lit in very long time. You notice a small plaque around the bottom edge of the lamp

>[3] x lamp
You are able to rub some debris from the plaque, revealing this message: "For use when presented by a maze of twisty little passages, all alike".

>[4] x lamp
"For use when presented by a maze of twisty little passages, all alike". (You have no idea what this means, do you?! Young people, *sigh*)

>[5] take lamp
Taken.

>[6] rub lamp
Look, there's no genie here so quit it.

>[7] rub lamp
Go on, keep rubbing. See if I care.

>[8] rub lamp
Go on, keep rubbing. See if I care.

>n
Ground floor stairs
A spiralling staircase, hemmed in by harsh railings and beige walls. The noise from the rest of the building provides a background hum of activity. 

The only way is UP! or something like that. 

There is a message board lining the walls of the stairwell.

Exits: south to ULU Entrance and up to First floor stairs.

>u
First floor stairs
A spiralling staircase, hemmed in by harsh railings and beige walls. The noise from the rest of the building provides a background hum of activity.

You see that the Gallery bar is north through the double doors. You can go down to the ground floor or up a few flights to the third floor.

Exits: down to Ground floor stairs, up to Third floor stairs, north and south.

>d
Ground floor stairs
A spiralling staircase, hemmed in by harsh railings and beige walls. The noise from the rest of the building provides a background hum of activity. 

The only way is UP! or something like that. 

There is a message board lining the walls of the stairwell.

Exits: south to ULU Entrance and up to First floor stairs.

>x board
A number of panels of dark gray message board, covered with miscellaneous student posters about society events, music parties, and sports. There are a few odd posters stuck up here too, you notice a poster sporting what looks like 8-bit Zelda graphics.

>test 1fstairs
(Testing.)

>[1] x board
A number of panels of dark gray message board, covered with miscellaneous student posters about society events, music parties, and sports. There are a few odd posters stuck up here too, you notice a poster sporting what looks like 8-bit Zelda graphics.

>[2] x message board
A number of panels of dark gray message board, covered with miscellaneous student posters about society events, music parties, and sports. There are a few odd posters stuck up here too, you notice a poster sporting what looks like 8-bit Zelda graphics.

>[3] x strip
You can't see any such thing.

>[4] x miscellaneous posters
It looks like someone loaded a shotgun with dozens of fonts, colours and jarring designs and shot it repeatedly at the wall. 

There are party flyers advertising certain DJs playing in certain venues which, as you have no idea who the DJs are, fails to get you interested. You see some notices about various sports clubs, at which point your eyes glaze over and involuntarily, you start to read from the next poster, which seems to have something about student welfare on it. None of the posters seem to contain important information. Only the strange zelda poster that you noticed before that is of interest to you.

>[5] x poster
The sheet is a scene from the very first Zelda game. Above an old man who is standing between two bright red blocky fires is text that reads: "It is dangerous to go alone. Take this!". The bottom of the sheet has been cut into little strips that you can pull off. Printed onto each is an orange sword, the master sword from the game. 

Neat.

>[6] x zelda poster
The sheet is a scene from the very first Zelda game. Above an old man who is standing between two bright red blocky fires is text that reads: "It is dangerous to go alone. Take this!". The bottom of the sheet has been cut into little strips that you can pull off. Printed onto each is an orange sword, the master sword from the game. 

Neat.

>[7] x strip
You see nothing special about the master sword paper strip.

>[8] take strip
Even though It's not that dangerous to go alone, you tear the strip from the bottom of the poster. 

Scaredy cat.

>[9] x stairwell
You see nothing special about the Main Stairwell.

>[10] listen to stairwell
Chattering voices from all floors are funnelled and compressed together with the footsteps of people in this stairwell. The sounds bounce and rebound along the walls, turning into a generic murmur of activity, with no one sound being distinguishable from the next..

>[11] take strip
You already have that.

>[12] drop strip
Dropped.

>[13] take strip
Taken.

I beg your pardon?

>s
ULU Entrance
The shop is still closed it seems and the Sisyphean challenge of keeping the bar stocked with booze and J20 is still ongoing. Students are still quietly working and chatting in the seated area.

You see a flimsy, trestle table - weighed down with a pile of retro-game flyers - that someone has attempted to make look dusty and old with the handicap of using only glitter, tinsel and coloured paper.

For some reason, a slightly warped plastic arrow is also on the table. You also spot a red fish sprinkled with glitter. It is not obvious why someone has done this unless it's a desperate cry for help. A shiny red keycard is poking out from underneath the fish.

Exits: north to Ground floor stairs.

>take table
That's fixed in place.

>look under the table
You find the hidden-under-the-table notice!

>x notice
"The Desk of Obligatory Tropes".

(Ah, go on. Have a point.)

[Your score has just gone up by one point.]

>x notice
"The Desk of Obligatory Tropes".

I beg your pardon?

* * *

>s
Corridor - Middle
You turn left into a small open area alongside a beige-coloured corridor, the same disappointing shade as that used in the stairwell. There is a busy woman sat behind a cluttered desk. To the south you can see the doors to rooms 3C and 3D.  The corridor continues east towards a set of closed doors, and west, towards what sounds like the rest of the conference.

You can see a busy woman here.

Exits: east, west, north to Third floor stairs, southeast and southwest.

You can hear a murmur coming from the west. It sounds like everyone is down that way You'd better hurry.

>hi
(addressing the busy woman)
You greet the woman behind the registration desk.

"Hello! What is it you need?" she asks while sorting various items on the desk.

(You could ask her about the Dev8D lanyard.)

>ask about the lanyard
She looks up briefly from her lists and says "They are about to start in the basecamp, you'd better get there soon! Don't worry, they'll be plenty of time to register afterwards."

I beg your pardon?

>w
Corridor - West
corridor west.

>w
Corridor - Westmost
BASECAMP CORRIDOR.

>w
You can't go that way.

>w
You can't go that way.

>n
Basecamp
BASECAMP DESC.

On the refreshments table is tea, coffee and a snack buffet. A selection of different types of snacks piled high - mainly muffins. In fact, on closer inspection, it looks like a muffin re-enactment of the Ambassador's Ferraro Rocher pyramid.

Welcome.

>z
Time passes.

2nd line.

>z
Time passes.

If you haven't yet registered and picked up your Dev8D lanyard, please do so as soon as you can - it has your name on it!

* * *

>z
Time passes.

>take code
It is encrypted - you can't tell if it is important information or a recipe for caesar salad.
.

>examine code
A piece of paper, torn off from a larger piece. It is covered in lots of capital letters, arranged in a grid: 

vmdmzowvvioqdmgwccxv
mdmzowvvitmbgwclwevv
mdmzowvvizcvizwcvliv
llmamzbgwcvmdmzowvvi
uismgwckzgvmdmzowvvi
aigowwljgmvmdmzowvvi
bmttitqmivlpczbgwc

 Odd.

>s
Corridor - Westmost
BASECAMP CORRIDOR.

>e
Corridor - West
corridor west.

>e
Corridor - Middle
REGISTRATION DESK CORRIDOR.

You can see a helpful woman here.

>se
3C
ROOM GENERIC DESCRIPTION.

You can see Ben O'Steen here.

>hi
(addressing Ben O'Steen)
You say hello to Ben O'Steen.

(You could ask him about Cryptography or Programming languages.)

>ask about python
Ben O'Steen does not respond.

>wear lanyard
You can't see any such thing.

>inv
You are carrying:
  a strange code fragment

>n
Corridor - Middle
REGISTRATION DESK CORRIDOR.

You can see a helpful woman here.

>hi
(addressing the helpful woman)
You say "Hi". 

 Hello!  What is it you need? 
(You could ask her about the Dev8D lanyard.)

>lanyard
She runs her finger along the badges, looking for yours. "Ah, here we go! Now, the doors to all the main rooms are south along this corridor. If you have any other questions, just ask!"

>i
You are carrying:
  the Dev8D lanyard
  a strange code fragment

>wear lanyard
You put on the Dev8D lanyard.

>i
You are carrying:
  the Dev8D lanyard (being worn)
  a strange code fragment

>se
3C
ROOM GENERIC DESCRIPTION.

You can see Ben O'Steen here.

>show fragment to ben
Ben O'Steen does not respond.

>n
Corridor - Middle
REGISTRATION DESK CORRIDOR.

You can see a helpful woman here.

>w
Corridor - West
corridor west.

* * *

>w
Corridor - Westmost
BASECAMP CORRIDOR.

>n
Basecamp
BASECAMP DESC.

On the refreshments table is tea, coffee and a snack buffet. A selection of different types of snacks piled high - mainly muffins. In fact, on closer inspection, it looks like a muffin re-enactment of the Ambassador's Ferraro Rocher pyramid.

>pick up table
That's fixed in place.

>take muffin
Taken (gingerly, not disturbing the pyramid).

>s
Corridor - Westmost
BASECAMP CORRIDOR.

* * *

>se
3C
ROOM GENERIC DESCRIPTION.

You can see Ben O'Steen here.

>give muffin to ben
His eyes widen. He grabs the muffin and immediately starts to eat it. You can barely make out "Wonderful!" and "Thank you!" being said through the crumbs.

>i
You are carrying:
  the Dev8D lanyard (being worn)
  a strange code fragment

>feed the muffin to ben
You can't see any such thing.

>give the fragment to ben
Ben O'Steen does not respond.

>eat muffin
You can't see any such thing.

>n
Corridor - Middle
REGISTRATION DESK CORRIDOR.

You can see a helpful woman here.

* * *

>n
Basecamp
BASECAMP DESC.

On the refreshments table is tea, coffee and a snack buffet. A selection of different types of snacks piled high - mainly muffins. In fact, on closer inspection, it looks like a muffin re-enactment of the Ambassador's Ferraro Rocher pyramid.

>take
(the refreshments table)
That's fixed in place.

>take muffin
Taken (gingerly, not disturbing the pyramid).

>take snack
Taken (gingerly, not disturbing the pyramid).

>i
You are carrying:
  a lemon muffin
  a blueberry muffin
  the Dev8D lanyard (being worn)
  a strange code fragment

>take muffin
(from the magnificent selection before you)
Taken (gingerly, not disturbing the pyramid).

>take muffin
(from the magnificent selection before you)
Taken (gingerly, not disturbing the pyramid).

>i
You are carrying:
  a plain muffin
  a lemon muffin
  a blueberry muffin
  the Dev8D lanyard (being worn)
  a strange code fragment

>s
Corridor - Westmost
BASECAMP CORRIDOR.

* * *

>se
3C
ROOM GENERIC DESCRIPTION.

You can see Ben O'Steen here.

>give all muffins to ben
You can't use multiple objects with that verb.

>give plain muffin to ben
Urgh, a plain bran muffin? I really appreciate that you got me this, but ... bran?

>eat plain muffin
You eat the plain muffin. Not bad.

>give chocolate muffin to ben
You can't see any such thing.

>i
You are carrying:
  a lemon muffin
  a blueberry muffin
  the Dev8D lanyard (being worn)
  a strange code fragment

>eat muffin
Which do you mean, the lemon muffin or the blueberry muffin?

>b
You can't see any such thing.

>blueberry
A blueberry muffin.

>eat muffin
Which do you mean, the lemon muffin or the blueberry muffin?

>blueberry
You eat the blueberry muffin. Not bad.

>eat
What do you want to eat?

>muffin
You eat the lemon muffin. Not bad.

>i
You are carrying:
  the Dev8D lanyard (being worn)
  a strange code fragment

>hi
You are already talking to Ben O'Steen.

>topics
You could ask him about Cryptography or Programming languages.

>ask about ciphers
Ben O'Steen does not respond.

>ask about cryptography
He looks up at the mention of cryptography. "Is someone is doing a lightning talk on it this year? It would be cool if someone was... What do you want to know about it? Do you know about the simple stuff like caesar or substitution ciphers or more advanced, shiny codes?"

(You could ask him about Cryptography, Caesar cipher, substitution cipher, or Programming languages.)

>ask about caesar
Imagine the alphabet you want to use written out twice, one row above another. For example :

A B C D E F G H I...
A B C D E F G H I...

By shifting the second row to the right or left by some number of letters, say, 3 letters to the right, you can create a caesar cipher encoder:

A B C D E F G H I...
X Y Z A B C D E F...
(Note that the letters wrap around.)

 To encode a letter, you find it on the top row and use the letter under it. In this way, BED becomes YBA, HAG becomes EXD and so on. ROT-13 ("rotate by 13") is a well known variation on the caesar cipher. Pretty easy to code a ROT in python too.

(You could ask him about Cryptography, Caesar cipher, substitution cipher, ROT code, or Programming languages.)

>ask about rot
He looks puzzled. "You really need me to tell you? Well, you did feed me, so let's see, you just need to turn each letter into a number, add or subtract the shift amount to it, wrap that answer around if necessary and turn it back to text... this should do the trick in python..." He opens a new terminal on his laptop and begins to type up the following code:

    def encode(txt, n): return "".join([chr((ord(c)-ord("a")+n) % 26 + ord("a")) for c in txt.lower()])

"Of course, this doesn't handle spaces and punctuation, but you get the idea!"

I beg your pardon?

>n
Corridor - Middle
REGISTRATION DESK CORRIDOR.

You can see a helpful woman here.

>n
Stairwell 3F
STAIRWELL 3F DESC.

>d
Stairwell 1F
STAIRWELL 1F DESC.

>d
Stairwell G
STAIRWELL G DESC.

>s
ULU Entrance
ULU GROUND FLOOR DESCRIPTION.

You can see a dusty table (on which is an old lamp here) here.

>x table
On the dusty table is an old lamp here.

>x lamp
It looks like an old Davy lamp, covered with joke-shop cobwebs and glitter.

>x lamp
 It looks like it hasn't been lit in very long time. You notice a small plaque around the bottom edge of the lamp

>x lamp
You are able to rub some debris from the plaque, revealing this message: "For use when presented by a maze of twisty little passages, all alike".

>x lamp
"For use when presented by a maze of twisty little passages, all alike". (You have no idea what this means, do you?! Young people, *sigh*)

>x lamp
"For use when presented by a maze of twisty little passages, all alike". (You have no idea what this means, do you?! Young people, *sigh*)

* * *

>hi
(addressing the busy woman)
You greet the woman behind the registration desk.

"Hello! What is it you need?" she asks while sorting various items on the desk.

(You could ask her about the Dev8D lanyard.)

>ask about lanyard
She looks up briefly from her lists and says "They are about to start in the basecamp, you'd better get there soon! Don't worry, they'll be plenty of time to register afterwards."

>w
Corridor - West
You walk on, towards the noise. You can see that the corridor continues north, before turning west again. The entrance to room 3E is to the south.

Exits: east to Corridor - Middle, north and south.

>n
Corridor - Westmost
This part of the corridor narrows slightly and snakes around a corner where it ends. The set of double doors to the north lead to the Basecamp.

Exits: south to Corridor - West and north.

>n
Basecamp
You enter the door and come face-to-face (well, face-to-back) with a crowd of people, all of whom are looking intently towards the other side of the room.

You can see Mahendra Mahey here.

Exits: south to Corridor - Westmost.

It seems that things are just about to start, so you press forward to get a decent enough view. You manoeuvre through the throng of developers, hackers, academics and other delegates as politely as you can until you manage to get a view of the organiser who is just about to speak.

"Welcome! Thank you all for coming to this, the fourth Dev8D! The fourth! There are a lot of new faces out there which is excellent, great to see and I also see many people I've met before, which is doubly excellent! Helping people meet up and talk about the things that interest them or even stump them is why we are here. Many of you work in small teams of developers - sometimes, it's just you! It is easy to feel isolated as you tackle problems on your own. Sometimes, you are trying to fix the problems you caused trying to fix the first time around!"

You hear quite a few knowing laughs from the people in the crowd. Seems you aren't alone here after all.

I beg your pardon?

>z
Time passes.

He continues. "This conference runs a little differently to what you might have experienced at other events. The focus in on practical skills, so the hands-on sessions outnumber the death-by-powerpoint talks." He turns round, and you catch a glimpse through the crowd of the schedule projected against the wall. Pointing at this, he says "The day starts formally, with workshops and talks targeted at what we feel are core skills. Lunch follows this, which is a perfect time to meet other people who might be working in the same areas or have the same interests as you. Then, there is the section focussed on emerging technologies - that is, things you might not be using right now but really should know about for the future. And then there is the final part of the day which is all about pushing the ideas of the day further. This will run a little differently to normal."

Even with the limited view of the schedule that you have, you can still see that unlike the other sections of the day, this one is oddly empty.

>z
Time passes.

"The purpose of the event is to work for you, everyone here" he says, pointing at the crowd. "The day, as with other conferences, starts off with our best guess at the kinds of topics you want to learn about."

"The difference is that we want it to end with the sessions you want."

The crowd has gone quiet. You can't tell whether it's from confusion at the idea or they are still in a zombie-like morning daze.

>z
Time passes.

He points at the back of the room "You might've seen the board at the back of the room as you walked in. It has the schedule, but more importantly, it has space to write ideas on. These should be the ideas you want taken further, birds-of-a-feather meetings, impromptu workshops, discussions about the ideas raised by the lightning talks you have heard, code-reviews meetups, knitting circles, reruns of earlier sessions because you managed to convince the workshop trainer to do so... in short, make it the event you want."

You notice people talking around you, no doubt conspiring with one another about what session they'd like to run. Someone in the crowd to your left shouts out "Skyrim!", followed by loud chuckles from a number of people in the crowd.

>z
Time passes.

You look back towards the front to see the speaker laughing as well. "Yes, I've been sucked into that too. I tell you what, you can put up a Skyrim Anonymous session, as an intervention to help us all break the addiction!"

"We have a limited number of slots available in the main rooms for this, so it will not be a first-come-first-serve arrangement. You can put your Skyrim idea up there, but you will need people to vote for it for it to get a slot. We are going to try "dotmocracy", where using a whiteboard marker, you simply put one dot next to the session you want to happen. You'll each have three dots to place each day. We are all adults here... well, most of us are, so I'm leaving it up to your own sense of honour to only vote three times."

He points towards the back of the room again. "The running schedule for the last part of the day will be written up and fixed in place a little while before we start it, so make sure you suggest ideas or vote before then!"

* * *

>s
Corridor - Middle
You turn left into a small open area alongside a beige-coloured corridor, the same disappointing shade as that used in the stairwell. There is a busy woman sat behind a cluttered desk. To the south you can see the doors to rooms 3C and 3D.  The corridor continues east towards a set of closed doors, and west, towards what sounds like the rest of the conference.

You can see a busy woman here.

Exits: east, west, north to Third floor stairs, southeast and southwest.

You can hear a murmur coming from the west. It sounds like everyone is down that way You'd better hurry.

>w
Corridor - West
You walk on, towards the noise. You can see that the corridor continues north, before turning west again. The entrance to room 3E is to the south.

Exits: east to Corridor - Middle, north and south.

>w
You can't go that way.

>n
Basecamp
BASECAMP DESC.

On the refreshments table is tea, coffee and a snack buffet. A selection of different types of snacks piled high - mainly muffins. In fact, on closer inspection, it looks like a muffin re-enactment of the Ambassador's Ferraro Rocher pyramid.

Exits: south to Corridor - Westmost.

Welcome.

* * *

>w
You can't go that way.

>n
Corridor - Westmost
This part of the corridor narrows slightly and snakes around a corner where it ends. The set of double doors to the north lead to the Basecamp.

Exits: south to Corridor - West and north.

>z
Time passes.

2nd line.

* * *

>z
Time passes.

If you haven't yet registered and picked up your Dev8D lanyard, please do so as soon as you can - it has your name on it!

>take fragment
You take the paper, but at a glance you can tell that what is on it is encrypted - you can't tell if it is important information or a recipe for caesar salad.

>x fragment
A piece of paper, torn off from a larger piece. It is covered in lots of lower-case letters, arranged mostly as a block of characters with a fixed spacing between characters reminiscent of a computer terminal.
----------------------------

zqkszwtt

vmdmzowvvioqdmgwccxv
mdmzowvvitmbgwclwevv
mdmzowvvizcvizwcvliv
llmamzbgwcvmdmzowvvi
uismgwckzgvmdmzowvvi
aigowwljgmvmdmzowvvi
bmttitqmivlpczbgwc

----------------------------

Odd.

>x fragment
A piece of paper, torn off from a larger piece. It is covered in lots of lower-case letters, arranged mostly as a block of characters with a fixed spacing between characters reminiscent of a computer terminal.
----------------------------

zqkszwtt

vmdmzowvvioqdmgwccxv
mdmzowvvitmbgwclwevv
mdmzowvvizcvizwcvliv
llmamzbgwcvmdmzowvvi
uismgwckzgvmdmzowvvi
aigowwljgmvmdmzowvvi
bmttitqmivlpczbgwc

----------------------------

Odd.

>take muffin
A chocolate muffin.
Taken (gingerly, not disturbing the pyramid).

>take muffin
(from the magnificent selection before you)
You open your hand to reveal yet-another-chocolate muffin. You put it back as one is enough.

>take muffin
(from the magnificent selection before you)
A blueberry muffin.
Taken (gingerly, not disturbing the pyramid).

>take muffin
(from the magnificent selection before you)
A plain, bran muffin. What joy.
Taken (gingerly, not disturbing the pyramid).

>take muffin
(from the magnificent selection before you)
You may have hands like a surgeon when it comes to getting muffins out of a stack like this, but you've just picked up another plain muffin. You put it back as carrying one around is bad enough.

* * *

>z
Time passes.

2nd line.

>x table
You can't see any such thing.

* * *

>s
You slip out and leave them to it.

>look
Corridor - Westmost
This part of the corridor narrows slightly and snakes around a corner where it ends. The set of double doors to the north lead to the Basecamp.

Exits: south to Corridor - West and north to Basecamp.

You hear a lull in the background chatter.

>n
Basecamp
Normal BASECAMP DESC.

You can see Mahendra Mahey here.

Exits: south to Corridor - Westmost.

He points at the back of the room "You might've seen the board at the back of the room as you walked in. It has the schedule, but more importantly, it has space to write ideas on. These should be the ideas you want taken further, birds-of-a-feather meetings, impromptu workshops, discussions about the ideas raised by the lightning talks you have heard, code-reviews meetups, knitting circles, reruns of earlier sessions because you managed to convince the workshop trainer to do so... in short, make it the event you want."

You notice people talking around you, no doubt conspiring with one another about what session they'd like to run. Someone in the crowd to your left shouts out "Skyrim!", followed by loud chuckles from a number of people in the crowd.

* * *

>s
Corridor - Middle
You turn left into a small open area alongside a beige-coloured corridor, the same disappointing shade as that used in the stairwell. There is a busy woman sat behind a cluttered desk. To the south you can see the doors to rooms 3C and 3D.  The corridor continues east towards a set of closed doors, and west, towards what sounds like the rest of the conference.

You can see a busy woman here.

Exits: east, west, north to Third floor stairs, southeast and southwest.

You can hear a murmur coming from the west. It sounds like everyone is down that way You'd better hurry.

>z
Time passes.

>z
Time passes.

>z
Time passes.

You hear a lull in the background chatter.

>w
Corridor - West
You walk on, towards the noise. You can see that the corridor continues north, before turning west again. The entrance to room 3E is to the south.

Exits: east to Corridor - Middle, north and south.

A small group of students, talking loudly, pass by you on their way to the stairs.

>w
You can't go that way.

* * *

>u
Third floor stairs
A spiralling staircase, hemmed in by harsh railings and beige walls. The noise from the rest of the building provides a background hum of activity.

Exits: south and down to First floor stairs.

I beg your pardon?

>s
Corridor - Middle
REGISTRATION DESK CORRIDOR.

You can see a helpful woman here.

>w
Corridor - West
corridor west.

* * *

>w
Corridor - Westmost
BASECAMP CORRIDOR.

>n
Basecamp
BASECAMP DESC.

You can see a refreshments table (on which are thirty Muffins, a tea, a Coffee, and a strange code) here.

Welcome.

>s
You should stay and listen. (Type "wait" or "z" to skip on through the speech.)

2nd line.

>z
Time passes.

If you haven't yet registered and picked up your Dev8D lanyard, please do so as soon as you can - it has your name on it!

* * *

>z
Time passes.

>s
Corridor - Westmost
BASECAMP CORRIDOR.

>n
Basecamp
BASECAMP DESC.

You can see a refreshments table (on which are thirty Muffins, a tea, a Coffee, and a strange code) here.

>z
Time passes.

* * *

>s
Corridor - Westmost
BASECAMP CORRIDOR.

I beg your pardon?

>n
Basecamp
BASECAMP DESC.

You can see a refreshments table (on which are thirty Muffins, a tea, a Coffee, and a strange code) here.

>take a muffin
Taken.

>take a coffee
Taken.

>eat muffin
You eat the Muffin. Not bad.

>drink coffee
Just what you needed.

I beg your pardon?

>inv
You are carrying nothing.

>look
Basecamp
BASECAMP DESC.

You can see a refreshments table (on which are a Coffee, twenty-nine Muffins, a tea, and a strange code) here.

>s
Corridor - Westmost
BASECAMP CORRIDOR.

>3d
That noun did not make sense in this context.

>s
You can't go that way.

>e
Corridor - West
corridor west.

>se
You can't go that way.

>e
Corridor - Middle
REGISTRATION DESK CORRIDOR.

You can see a helpful woman here.

* * *

>se
3C
ROOM GENERIC DESCRIPTION.

You can see Ben O'Steen here.

>n
Corridor - Middle
REGISTRATION DESK CORRIDOR.

You can see a helpful woman here.

>say hi to the woman
You say "Hi". 

 Hello!  What is it you need? 
(You could ask her about the Dev8D lanyard.)

>ask about the Dev8D Lanyard
She runs her finger along the badges, looking for yours. "Ah, here we go! Now, the doors to all the main rooms are south along this corridor. If you have any other questions, just ask!"

>inv
You are carrying:
  the Dev8D lanyard

I beg your pardon?

>se
3C
ROOM GENERIC DESCRIPTION.

You can see Ben O'Steen here.

>examine developer
You can't see any such thing.

>look
3C
ROOM GENERIC DESCRIPTION.

You can see Ben O'Steen here.

>examine ben
Sat in front of a creaking, whirring and otherwise straining laptop is a large, bearded man. He'd be sitting perfectly still if it wasn't for his hands moving back and forth across the keys, occasionally moving to slam repeatedly down on the "delete" key.  His nametag reads: 

 "Ben O'Steen - @benosteen".

>say hi
(addressing Ben O'Steen)
You say hello to Ben O'Steen.

(You could ask him about Programming languages.)

>examine ben
 His nametag reads: 

 "Ben O'Steen - @benosteen".

>ask about languages
He replies "My favourite language to work in is python. I find it really readable and straightforward to get things done in.
"
(You could ask him about Python or Programming languages.)

>say hi
You are already talking to Ben O'Steen.

>topics
You could ask him about Python or Programming languages.

>ask about python
"I think it's a wonderful language - whether it is the "best" one to learn is really dependent on what you want to get done but... I think it's one of the most fun!"

>n
Corridor - Middle
REGISTRATION DESK CORRIDOR.

You can see a helpful woman here.

>q
Are you sure you want to quit?

* * *

>w
Corridor - West
corridor west.

* * *

>w
Corridor - Westmost
BASECAMP CORRIDOR.

>n
Basecamp
BASECAMP DESC.

You can see a refreshments table (on which are a Coffee, twenty-nine Muffins, a tea, and a strange code) here.

>take code
This looks like it is encrypted with some sort of code.

>s
Corridor - Westmost
BASECAMP CORRIDOR.

* * *

>se
3C
ROOM GENERIC DESCRIPTION.

You can see Ben O'Steen here.

>say hi
(addressing Ben O'Steen)
You say hello to Ben O'Steen.

(You could ask him about Python, Cryptography, or Programming languages.)

>ask about crypto
Ben O'Steen does not respond.

>ask about cryptography
He looks up at the mention of cryptography. "Is someone is doing a lightning talk on it this year? It would be cool if someone was... What do you want to know about it? Do you know about the simple stuff like caesar or substitution ciphers or more advanced, shiny codes?"

(You could ask him about Python, Cryptography, Caesar cipher, substitution cipher, or Programming languages.)

>topics
You could ask him about Python, Cryptography, Caesar cipher, substitution cipher, or Programming languages.

>ask about caesar
Imagine the alphabet you want to use written out twice, one row above another. For example :

A B C D E F G H I...
A B C D E F G H I...

By shifting the second row to the right or left by some number of letters, say, 3 letters to the right, you can create a caesar cipher encoder:

A B C D E F G H I...
X Y Z A B C D E F...
(Note that the letters wrap around.)

 To encode a letter, you find it on the top row and use the letter under it. In this way, BED becomes YBA, HAG becomes EXD and so on. ROT-13 ("rotate by 13") is a well known variation on the caesar cipher. Pretty easy to code a ROT in python too.

(You could ask him about Python, Cryptography, Caesar cipher, substitution cipher, ROT code, or Programming languages.)

>topics
You could ask him about Python, Cryptography, Caesar cipher, substitution cipher, ROT code, or Programming languages.

>ask about rot code
You really need me to tell you? Well, let's see, you just need to turn each letter into a number, add or subtract the shift amount to it, wrap that answer around if necessary and turn it back to text... this should do the trick in python:

    def encode(txt, n): return "".join([chr((ord(c)-ord("a")+n) % 26 + ord("a")) for c in txt.lower()])

* * *

>u
Third floor stairs
A spiralling staircase, hemmed in by harsh railings and beige walls. The noise from the rest of the building provides a background hum of activity.

Exits: south and down to First floor stairs.

>u
You can't go that way.

>s
Corridor - Middle
REGISTRATION DESK CORRIDOR.

You can see a helpful woman here.

Exits: north to Stairwell 3F, west, southeast, southwest and east.

>w
Corridor - West
corridor west.

Exits: east to Corridor - Middle, west and south.

I beg your pardon?

>w
Corridor - Westmost
BASECAMP CORRIDOR.

Exits: east to Corridor - West and north.

>n
Basecamp
BASECAMP DESC.

You can see a refreshments table (on which are a tea, a Coffee, a snack buffet, and a strange code fragment) here.

Exits: south to Corridor - Westmost.

Welcome.

>z
Time passes.

2nd line.

* * *

>take fragment
You take the paper, but at a glance you can tell that what is on it is encrypted - you can't tell if it is important information or a recipe for caesar salad.

>x frag
You can't see any such thing.

>x fragment
A piece of paper, torn off from a larger piece. It is covered in lots of lower-case letters, arranged mostly as a block of characters with a fixed spacing between characters reminiscent of a computer terminal.
----------------------------

zqkszwtt

vmdmzowvvioqdmgwccxv
mdmzowvvitmbgwclwevv
mdmzowvvizcvizwcvliv
llmamzbgwcvmdmzowvvi
uismgwckzgvmdmzowvvi
aigowwljgmvmdmzowvvi
bmttitqmivlpczbgwc

----------------------------
Odd.

>x fragment
A piece of paper, torn off from a larger piece. It is covered in lots of lower-case letters, arranged mostly as a block of characters with a fixed spacing between characters reminiscent of a computer terminal.
----------------------------

zqkszwtt

vmdmzowvvioqdmgwccxv
mdmzowvvitmbgwclwevv
mdmzowvvizcvizwcvliv
llmamzbgwcvmdmzowvvi
uismgwckzgvmdmzowvvi
aigowwljgmvmdmzowvvi
bmttitqmivlpczbgwc

----------------------------
Odd.

* * *

>u
Third floor stairs
A spiralling staircase, hemmed in by harsh railings and beige walls. The noise from the rest of the building provides a background hum of activity.

Exits: south and down to First floor stairs.

>abstract me to 3D
[Abstracted.]

I beg your pardon?

>lok
That noun did not make sense in this context.

>look
3D
In 3D you can see a large Project room desk (on which is a whirring laptop) and Ben O'Steen.

Exits: south and down to First floor stairs.

>x laptop
This poor machine is obviously doing 8 things at the same time from the noise it's making. That, or just that it really needs to be cleaned.

>x ben
Sat in front of a creaking, straining but mainly loudly whirring laptop is a large, bearded man. He'd be sitting perfectly still if it wasn't for his hands moving back and forth across the keys, occasionally moving to slam repeatedly down on the "delete" key. His nametag reads: 

 "Ben O'Steen - @benosteen".

>x ben
His nametag reads: 

 "Ben O'Steen - @benosteen".

>abstract me to 3D
[Abstracted.]

* * *

I beg your pardon?

>x tables of developers
You can't see any such thing.

>showme tables of developers
There seems to be no such object anywhere in the model world.

>showme tables of developers
There seems to be no such object anywhere in the model world.

>showme table of developers
There seems to be no such object anywhere in the model world.

>showme stairwell
(Region Stairwell)
Region Stairwell - region
singular-named, proper-named; unmarked for special listing
printed name: "Region Stairwell"
printed plural name: "regions"
indefinite article: none

>showme Main Stairwell
Main Stairwell - backdrop
location: in Third floor stairs
singular-named, improper-named; unlit, inedible, fixed in place, scenery, neuter, unmarked for special listing, ordinarily enumerated, unseen, unfamiliar, keywordless, used
printed name: "Main Stairwell"
printed plural name: "backdrops"
indefinite article: none
description: none
initial appearance: none
keyword: none
sound: "Chattering voices from all floors are funnelled and compressed together with the footsteps of people in this stairwell. The sounds bounce and rebound along the walls, turning into a generic murmur of activity, with no one sound being distinguishable from the next."
smell: "nothing"

>showme developers
There seems to be no such object anywhere in the model world.

* * *

>u
First floor stairs
A spiralling staircase, hemmed in by harsh railings and beige walls. The noise from the rest of the building provides a background hum of activity.

You see that the Gallery bar is north through the double doors, but now is no time to take a drink. You can go down to the ground floor or up a few flights to the third floor, which is where most of Dev8D will take place.

Exits: down to Ground floor stairs, up, north and south.

>n
Gallery
GALLERY DESCRIPTION.

Exits: south to First floor stairs and west.

>s
Stairwell 1F
STAIRWELL 1F DESC.

Exits: down to Stairwell G, up, north to the Gallery and south.

>u
Stairwell 3F
STAIRWELL 3F DESC.

Exits: down to Stairwell 1F and south.

>s
Corridor - Middle
REGISTRATION DESK CORRIDOR.

You can see a helpful woman here.

Exits: north to Stairwell 3F, west, southeast, southwest and east.

* * *

>w
Corridor - Westmost
BASECAMP CORRIDOR.

Exits: east to Corridor - West and north.

>n
Basecamp
BASECAMP DESC.

On the refreshments table is tea, coffee and a snack buffet. A selection of different types of snacks piled high - mainly muffins. In fact, on closer inspection, it looks like a muffin re-enactment of the Ambassador's Ferraro Rocher pyramid.

Exits: south to Corridor - Westmost.

Welcome.

I beg your pardon?

>z
Time passes.

2nd line.

* * *

>z
Time passes.

>take snack
Taken (gingerly, not disturbing the pyramid).

>i
You are carrying:
  a lemon muffin

>take snack
Taken (gingerly, not disturbing the pyramid).

* * *

>i
You are carrying:
  a lemon muffin

>s
Corridor - Westmost
BASECAMP CORRIDOR.

Exits: east to Corridor - West and north to Basecamp.

* * *

>e
Corridor - West
corridor west.

Exits: east to Corridor - Middle, west to Corridor - Westmost and south.

>e
Corridor - Middle
REGISTRATION DESK CORRIDOR.

You can see a helpful woman here.

Exits: north to Stairwell 3F, west to Corridor - West, southeast, southwest and east.

>se
3C
ROOM GENERIC DESCRIPTION.

You can see Ben O'Steen and a simple desk (on which is a straining laptop) here.

Exits: northwest to Corridor - Middle.

I beg your pardon?

>x laptop
This poor machine is obviously doing 8 things at the same time from the noise it's making. That, or just that it really needs to be cleaned.

>x ben
Sat in front of a creaking, whirring and otherwise straining laptop is a large, bearded man. He'd be sitting perfectly still if it wasn't for his hands moving back and forth across the keys, occasionally moving to slam repeatedly down on the "delete" key.  His nametag reads: 

 "Ben O'Steen - @benosteen".

>n
Corridor - Middle
REGISTRATION DESK CORRIDOR.

You can see a helpful woman here.

Exits: north to Stairwell 3F, west to Corridor - West, southeast to 3C, southwest and east.

>e
Corridor - East
corridor east.

Exits: west to Corridor - Middle, southeast and southwest.

>w
Corridor - Middle
REGISTRATION DESK CORRIDOR.

You can see a helpful woman here.

Exits: north to Stairwell 3F, west to Corridor - West, southeast to 3C, southwest and east to Corridor - East.

>w
Corridor - West
corridor west.

Exits: east to Corridor - Middle, west to Corridor - Westmost and south.

>w
Corridor - Westmost
BASECAMP CORRIDOR.

Exits: east to Corridor - West and north to Basecamp.

>w
You can't go that way.

>n
Basecamp
BASECAMP DESC.

On the refreshments table is tea, coffee and a snack buffet. A selection of different types of snacks piled high - mainly muffins. In fact, on closer inspection, it looks like a muffin re-enactment of the Ambassador's Ferraro Rocher pyramid.

Exits: south to Corridor - Westmost.

* * *

>n
Gallery
GALLERY DESCRIPTION.

Exits: south to First floor stairs and west.

>w
You should really head to the Basecamp room before it's too late!

>abstract me to The Venue
[Abstracted.]

I beg your pardon?

>look
The Venue
In the Venue you can see ARDrone and Dave Tarrant.

Exits: south to First floor stairs and west.

>hi
(addressing Dave Tarrant)
You address the coder.  "Hi!"

"Hello!  What do you want to talk about?"

(You could ask him about WiFi or ARDrone.)

>ARDrone
Placeholder.

I beg your pardon?

>Wifi
Placeholder.

>abstract me to 3C. Look
[Abstracted.]
3C
In 3C you can see Graham Klyne.

Exits: south to First floor stairs and west.

>hi
(addressing Graham Klyne)
You address the coder.  "Hi!"

"Hello!  What do you want to talk about?"

(You could ask him about 3D Printing.)

>3D printing
Placeholder.

* * *

>u
First floor stairs
A spiralling staircase, hemmed in by harsh railings and beige walls. The noise from the rest of the building provides a background hum of activity.

You see that the Gallery bar is north through the double doors, but now is no time to take a drink. You can go down to the ground floor or up a few flights to the third floor, which is where most of Dev8D will take place.

Exits: down to Ground floor stairs, up, north and south.

I beg your pardon?

>uu
That noun did not make sense in this context.

>u
Third floor stairs
A spiralling staircase, hemmed in by harsh railings and beige walls. The noise from the rest of the building provides a background hum of activity.

Exits: south and down to First floor stairs.

>s
Corridor - Middle
You turn left into a small open area alongside a beige-coloured corridor, the same disappointing shade as that used in the stairwell. There is a busy woman sat behind a cluttered desk. To the south you can see the doors to rooms 3C and 3D.  The corridor continues east towards a set of closed doors, and west, towards what sounds like the rest of the conference.

You can see a busy woman here.

Exits: east, west, north to Third floor stairs, southeast and southwest.

>x woman
You see a woman busily working away behind the registration desk, which is covered with conference lanyards and various lists. You are impressed that she is not only functional this early in the morning, but able to sort through all the information in front of her. Whatever she is looking at is complex enough to either be a foolproof and detailed plan for world domination, or just the food preferences of some of the delegates.

>x lanyards
A pile of alphabetically-sorted lanyards.

>x desk
The registration desk is covered by lanyards and lists. You are glad that none of the lists of information are of any consequence to you as they are nearly indecipherable!

>w
Corridor - West
.

Exits: east to Corridor - Middle, west and south.

>e
Corridor - Middle
The corridor widens here and provides access to the stairwell The entrances to rooms 3D and 3C are along the southern wall. The corridor continues east towards a set of closed doors, and west, towards what sounds like the rest of the conference.

You can see a busy woman here.

Exits: east, west to Corridor - West, north to Third floor stairs, southeast and southwest.

>e
Corridor - East
You follow the corridor along a little further, and reach some closed doors that block your progress. You note that as the doors to 3A and 3B are along the southern wall here, you won't need to go any further along in any case. You become acutely aware of the lack of natural light, as everything has gained a light yellow tone from the fluorescent lighting. The entrances to the male and female toilets are on the north wall.

Exits: west to Corridor - Middle, southeast, southwest, northwest and northeast.

>nw
As soon as your hand makes contact with the door, you realise you no longer feel the physical need to go. Well, at least you know where the toilets for next time.

A small group of students, talking loudly, pass you on their way to the stairs.

>x closed doors
You look through windows on the closed doors and see more corridor, but you feel that there is something odd here. Everything has a rough, jagged-looking edge to it as if it were a low-resolution picture. Even the colours of everything behind the doors are crudely blocky and flat.

You hear part of a conversation but can't work out where it is coming from. "... after lunch. I'll see you at the Computer vision session then? It'll b..." The conversation gets lost in the noise.

>x closed doors
You look through windows on the closed doors and see more corridor, but you feel that there is something odd here. Everything has a rough, jagged-looking edge to it as if it were a low-resolution picture. Even the colours of everything behind the doors are crudely blocky and flat.

* * *

>up
Stairwell 1F
STAIRWELL 1F DESC.

>u
Stairwell 3F
STAIRWELL 3F DESC.

>s
Corridor - Middle
REGISTRATION DESK CORRIDOR.

>s
You should really head to the Basecamp room before it's too late!

>sw
You should really head to the Basecamp room before it's too late!

>se
You should really head to the Basecamp room before it's too late!

>e
Corridor - East
corridor east.

>w
Corridor - Middle
REGISTRATION DESK CORRIDOR.

>w
Corridor - West
corridor west.

* * *

>w
Corridor - Westmost
BASECAMP CORRIDOR.

>n
Basecamp
BASECAMP DESC.

* * *

>uy
That noun did not make sense in this context.

>u
Stairwell 1F
STAIRWELL 1F DESC.

Exits: down to Stairwell G, up, north and south.

>u
Stairwell 3F
STAIRWELL 3F DESC.

Exits: down to Stairwell 1F and south.

>u
You can't go that way.

* * *

>z
Time passes.

If you haven't yet registered and picked up your Dev8D lanyard, please do so as soon as you can - it has your name on it!

>take frag
You can't see any such thing.

>take fragment
It is encrypted - you can't tell if it is important information or a recipe for caesar salad.
.

I beg your pardon?

* * *

>x message board
You can't see any such thing.

* * *

>test 1fstairs
(Testing.)

>[1] x board
A number of panels of dark gray message board, covered with miscellaneous student posters about society events, music parties, and sports. There are a few odd posters stuck up here too, you notice a poster sporting what looks like 8-bit Zelda graphics.

>[2] x message board
A number of panels of dark gray message board, covered with miscellaneous student posters about society events, music parties, and sports. There are a few odd posters stuck up here too, you notice a poster sporting what looks like 8-bit Zelda graphics.

>[3] x strip
You can't see any such thing.

>[4] x miscellaneous posters
It looks as if someone loaded a shotgun with hundreds of fonts, colours and jarring designs and fired it at the wall. Lots of special announcements regarding certain DJs playing in certain venues which, as you know neither the DJs nor the venues, fails to get you interested. You see some notices about various sports clubs, at which point your eyes glaze over. Involuntarily, your eyes move  to look at the next poster which has something to do with student welfare. None of these posters seem to contain important information. and it's only the strange zelda poster you noticed before that is keeping your attention.

>[5] x poster
The sheet is a scene from the very first Zelda game. Above an old man who is standing between two bright red blocky fires is text that reads: "It is dangerous to go alone. Take this!". The bottom of the sheet has been cut into little strips that you can pull off. Printed onto each is an orange sword, the master sword from the game. Neat.

>[6] x zelda poster
The sheet is a scene from the very first Zelda game. Above an old man who is standing between two bright red blocky fires is text that reads: "It is dangerous to go alone. Take this!". The bottom of the sheet has been cut into little strips that you can pull off. Printed onto each is an orange sword, the master sword from the game. Neat.

>[7] x strip
You see nothing special about the master sword paper strip.

>[8] take strip
Even thought It's not that dangerous too alone, you tear the strip from the bottom of the poster. Scaredy cat.

>[9] x stairwell
You see nothing special about the Main Stairwell.

>[10] listen to stairwell
Chattering voices from all floors are funnelled and compressed together with the footsteps of people in this stairwell. The sounds bounce and rebound along the walls, turning into a generic murmur of activity, with no one sound being distinguishable from the next..

>[11] take strip
You already have that.

>[12] drop strip
Dropped.

>[13] take strip
Taken.

>listen
You hear some sounds in this room, but you can't make out what is causing it.

>take strip
You tear the strip from the bottom of the poster. You vandal, you.

>take strip
You already have that.

>take strip
You already have that.

>drop strip
Dropped.

>take strip
Taken.

>inv
You are carrying:
  a master sword paper strip

* * *

>look
Ground floor stairs
A spiralling staircase, hemmed in by harsh railings and beige walls. The noise from the rest of the building provides a background hum of activity. 

The only way is UP! or something like that. 

There is a message board lining the walls of the stairwell.

Exits: south to ULU Entrance and up.

>up
First floor stairs
In the low-light of the stairwell, you see a set of sharp-angled stairs spiralling upwards, fenced in by a utilitarian handrail, supported by thin banisters. The parts of the walls you can see are the kind of beige colour that cannot be described accurately without the words "institutional" and "depressing". It won't be how the colour is officially labelled, but labels are rarely honest. The noise from the rest of the building provides a background hum of activity.

 You see that the Gallery bar is north through the double doors. You can go down to the ground floor or up a few flights to the third floor, which is where most of Dev8D will take place.

Exits: down to Ground floor stairs, north and south.

>down
Ground floor stairs
A spiralling staircase, hemmed in by harsh railings and beige walls. The noise from the rest of the building provides a background hum of activity. 

The only way is UP! or something like that. 

There is a message board lining the walls of the stairwell.

Exits: south to ULU Entrance and up to First floor stairs.

>take poster
You'd better not do that. You don't want to be thrown out for removing posters. At least, not until you've been at the event for a while.

>take board
You'd better not do that. You don't want to be thrown out for removing posters. At least, not until you've been at the event for a while.

>lick board
You really, really, REALLY don't want to do that. Just think of the germs!

>smell board
You can't smell anything.

>s
ULU Entrance
The shop is still closed it seems and the Sisyphean challenge of keeping the bar stocked with booze and J20 is still ongoing. Students are still quietly working and chatting in the seated area.

You see a flimsy, trestle table - weighed down with a pile of retro-game flyers - that someone has attempted to make look dusty and old with the handicap of using only glitter, tinsel and coloured paper.

Perched amongst the flyers, you see an old lamp. For some reason, a slightly warped plastic arrow is also on the table. You also spot a red fish sprinkled with glitter. It is not obvious why someone has done this unless it's a desperate cry for help.

Exits: north to Ground floor stairs.

>smell fish
Awful. Just... awful. And now you have got glitter on your cheek. Congratulations..

>n
Ground floor stairs
A spiralling staircase, hemmed in by harsh railings and beige walls. The noise from the rest of the building provides a background hum of activity. 

The only way is UP! or something like that. 

There is a message board lining the walls of the stairwell.

Exits: south to ULU Entrance and up to First floor stairs.

>u
First floor stairs
A spiralling staircase, hemmed in by harsh railings and beige walls. The noise from the rest of the building provides a background hum of activity.

 You see that the Gallery bar is north through the double doors. You can go down to the ground floor or up a few flights to the third floor.

Exits: down to Ground floor stairs, north and south.

>u
You can't go that way.

>s
Duck & Dive Bar
Duck and Dive bar description.

Exits: north to First floor stairs.

>w
You can't go that way.

>n
First floor stairs
A spiralling staircase, hemmed in by harsh railings and beige walls. The noise from the rest of the building provides a background hum of activity.

 You see that the Gallery bar is north through the double doors. You can go down to the ground floor or up a few flights to the third floor.

Exits: down to Ground floor stairs, north and south to the Duck & Dive Bar.

>z
Time passes.

>s
Duck & Dive Bar
Duck and Dive bar description.

Exits: north to First floor stairs.

>e
You can't go that way.

>e
You can't go that way.

>sw
You can't go that way.

>smell ben
You can't see any such thing.

>smell desk
You can't see any such thing.

* * *

>look
Ground floor stairs
A spiralling staircase, hemmed in by harsh railings and beige walls. The noise from the rest of the building provides a background hum of activity. 

The only way is up the stairs, or south, back to the entrance. 

There is a message board lining the walls of the stairwell.

Exits: up and south to ULU Entrance.

>u
First floor stairs
A spiralling staircase, hemmed in by harsh railings and beige walls. The noise from the rest of the building provides a background hum of activity.

You see that the Gallery bar is north through the double doors, but now is no time to take a drink. You can go down to the ground floor or up a few flights to the third floor, which is where most of Dev8D will take place.

Exits: down to Ground floor stairs, up, north and south.

* * *

>u
Third floor stairs
A spiralling staircase, hemmed in by harsh railings and beige walls. The noise from the rest of the building provides a background hum of activity.

Exits: south and down to First floor stairs.

>d
First floor stairs
A spiralling staircase, hemmed in by harsh railings and beige walls. The noise from the rest of the building provides a background hum of activity.

You see that the Gallery bar is north through the double doors. You can go down to the ground floor or up a few flights to the third floor.

Exits: down to Ground floor stairs, up to Third floor stairs, north and south.

I beg your pardon?

>x board
You can't see any such thing.

>d
Ground floor stairs
A spiralling staircase, hemmed in by harsh railings and beige walls. The noise from the rest of the building provides a background hum of activity. 

The only way is up the stairs, or south, back to the entrance. 

There is a message board lining the walls of the stairwell.

Exits: up to First floor stairs and south to ULU Entrance.

>x board
A number of panels of dark gray message board, covered with miscellaneous student posters about society events, music parties, and sports. There are a few odd posters stuck up here too, you notice a poster sporting what looks like 8-bit Zelda graphics.

>take strip
You can't see any such thing.

>x poster
The sheet is a scene from the very first Zelda game. Above an old man who is standing between two bright red blocky fires is text that reads: "It is dangerous to go alone. Take this!". The bottom of the sheet has been cut into little strips that you can pull off. Printed onto each is an orange sword, the master sword from the game. 

Neat.

>take strip
Even though It's not that dangerous to go alone, you tear the strip from the bottom of the poster. 

Scaredy cat.

>u
First floor stairs
A spiralling staircase, hemmed in by harsh railings and beige walls. The noise from the rest of the building provides a background hum of activity.

You see that the Gallery bar is north through the double doors. You can go down to the ground floor or up a few flights to the third floor.

Exits: down to Ground floor stairs, up to Third floor stairs, north and south.

>u
Third floor stairs
A spiralling staircase, hemmed in by harsh railings and beige walls. The noise from the rest of the building provides a background hum of activity.

Exits: south and down to First floor stairs.

>s
Corridor - Middle
REGISTRATION DESK CORRIDOR.

You can see a helpful woman here.

Exits: east, west, north to Third floor stairs, southeast and southwest.

>w
Corridor - West
corridor west.

Exits: east to Corridor - Middle, west and south.

* * *

>w
Corridor - Westmost
BASECAMP CORRIDOR.

Exits: east to Corridor - West and north.

>n
Basecamp
You enter the door and come face-to-face (well, face-to-back) with a crowd of people, all of whom are looking intently towards the other side of the room.

Exits: south to Corridor - Westmost.

It seems that things are just about to start, so you press forward to get a decent enough view. You manoeuvre through the throng of developers, hackers, academics and other delegates as politely as you can until you manage to get a view of the organiser who is just about to speak.

"Welcome! Thank you all for coming to this, the fourth Dev8D! Yes, fourth! I'm so glad to see lots of new faces out there, standing amongst the faces I already know well! You know, helping people meet up and talk about the things that interest or even stump you is one of the key reasons this event exists. Many of you work in small teams and can feel isolated. Sometimes you alone are the team!"

You hear quite a few knowing laughs from the people in the crowd. Seems you aren't alone here after all. (Maybe you should put that master sword back where you found it, eh?).

I beg your pardon?

I beg your pardon?

>z
Time passes.

He continues: "

>z
Time passes.

If you haven't yet registered and picked up your Dev8D lanyard, please do so as soon as you can - it has your name on it!

Basecamp
Normal BASECAMP DESC.

You can see a refreshments table (on which are coffee, tea, a snack buffet, and a strange code fragment) and a Basecamp schedule board here.

Exits: south to Corridor - Westmost.

>x board
BASECAMP SCHEDULE DESC.

>x buffet
A selection of different types of snacks piled high - mainly muffins. It looks like a muffin re-enactment of the Ambassador's Ferraro Rocher pyramid. There is a strange code fragment on the table.

>take fragment
You take the paper, but at a glance you can tell that it is encrypted - you can't tell if it will contain important information or a recipe for good Caesar salad. Well...  it's probably worth decoding then. Good recipes are hard to come by.

>push buffet
You place your hand on the pile of muffins to push it over. "Hey!" says a voice from across the table "You'll knock them all down! Stop that!". The people around you turn and begin to stare at you. You realise just how ridiculous you look at this moment, and make a tactical retreat from the table.

>eat buffet
You pull a chair up to the table and tuck a napkin into your shirt. You may be here some time.

Or so you thought. Everyone is looking puzzled at you. Perhaps you should just eat the muffins one at a time, like everyone else.

>actions
Actions listing on.

>eat buffet
[eating the snack buffet]
No, just one at a time. You were thinking about going on a diet soon anyhow.
[eating the snack buffet - ended without result]

>actions verbose
I only understood you as far as wanting to actions.

>actions off
Actions listing off.

>look
Basecamp
Normal BASECAMP DESC.

You can see a refreshments table (on which are coffee, tea, and a snack buffet) and a Basecamp schedule board here.

Exits: south to Corridor - Westmost.

>weat tea
That noun did not make sense in this context.

>eat tea
(first taking tea)
You spill quite a bit of tea down your front as you bite and chew into the paper cup. You attempt to drink it instead. 
You take a long slurp of tea. Lovely, lovely tea. Perfect. It's a shame the cups are so small!

>eat tea
(first taking tea)
You attempt to drink the tea instead. Remember what happened last time.

You take a long slurp of tea. Still hot too!

>push tea
All that will create is a puddle on the table. And do you know what a room full of developers who have sensitive, expensive electronics don't want?

That's right. That.

>push coffee
No.

>throw coffee at developers
NO FOOD FIGHTS! Seriously now. Imagine if your laptop got hit by coffee and ruined?

* * *

>go up
You can't go that way.

>go n
Stairwell G
STAIRWELL G DESC.

>go up
Stairwell 1F
STAIRWELL 1F DESC.

>n
Gallery
GALLERY DESCRIPTION.

>w
Venue
VENUE DESCRIPTION.

>e
Gallery
GALLERY DESCRIPTION.

>s
Stairwell 1F
STAIRWELL 1F DESC.

>s
Duck Dive Bar
Duck and Dive bar description.

>n
Stairwell 1F
STAIRWELL 1F DESC.

>u
Stairwell 3F
STAIRWELL 3F DESC.

>look s
You see nothing unexpected in that direction.

>s
corridor middle
REGISTRATION DESK CORRIDOR.

You can see ThreeC door and ThreeD door here.

I beg your pardon?

* * *

>look at table
On the dusty table is an old lamp here.

* * *

>x glitter
Glitter. Wonderful. You look forward to finding little pieces of this stuck to you for many days to come.

>x tinsel
An unpleasant, gaudy and cheap-looking relic attached to the edges of the table in an effort to make it look more festive. You die a little inside.

>x paper
You see nothing special about colour paper.

>x coloured paper
You can't see any such thing.

* * *

>test table
(Testing.)

>[1] look
ULU Entrance
ULU GROUND FLOOR DESCRIPTION.

In the foyer, you see a flimsy table - weighed down with a pile of retro-game flyers - that someone has attempted to make look dusty and old with the handicap of using only glitter, tinsel and coloured paper.  Perched amongst the flyers, you see an old lamp.

Exits: north.

>[2] x table
On the dusty table are an old lamp here and a retro-game flyer pile.

>[3] x glitter
Glitter. Wonderful. You look forward to finding little pieces of this stuck to you for many days to come.

>[4] x coloured paper
It's amazing what an artist can capture with just some scissors, glue and coloured paper. The person who decorated this table should've given them a call.

>[5] x tinsel
An unpleasant, gaudy and cheap-looking relic attached to the edges of the table in an effort to make it look more festive. You die a little inside.

>[6] x retro-game flyers
I only understood you as far as wanting to examine the retro-game flyer pile.

>[7] take flyer
You take one of the concertina'd flyers from the stack.

>[8] x flyer
(the poorly printed flyer)
The title of the flyer is "GET LAMP - Interactive fiction in the 21st century!". Further down the page you see an apology for stealing the flyer's title from "Jason's (@textfiles) awesome upcoming documentary, can't wait!!!". Hmm.

>[9] 
I beg your pardon?

>take retro-game flyers
I only understood you as far as wanting to take the retro-game flyer pile.

>i
You are carrying:
  a poorly printed flyer

>take pile
You shouldn't take more than one. These have obviously been printed on a student's budget!

>read flyer
(the poorly printed flyer)
(An uninspiring photo of a smartphone running some sort of terminal application.) You guess this must be interesting for some reason you cannot fathom as the caption text under it uses a lot of exclamation marks.

>read flyer
(the poorly printed flyer)
"Our Favourite Interactive Fiction games! (Check them out on IFDB) 

 - Blue Lacuna by Aaron A. Reed (Phenomenal!!)
 - Any and all of the Zork games
 - Vicious Cycles (http://bloomengine.com/cycles)
 - Photopia by Adam Cadre (strange and beautiful!)
Galatea by Emily Short
 - Collosal Cave Adventure (a classic!!)
 (... the list goes on for most of a page, with names like Emily Short reoccurring a few times. )

>read flyer
(the poorly printed flyer)
You read a passage about how graphical interfaces destroy the imagination. You stifle a laugh, knowing that whoever wrote this likely made it using MS Word. Mainly because of the overuse of Papyrus, Comic-sans and *scoff* Ariel.

>read flyer
(the poorly printed flyer)
The title of the flyer is "GET LAMP - Interactive fiction in the 21st century!". Further down the page you see an apology for stealing the flyer's title from "Jason's (@textfiles) awesome upcoming documentary, can't wait!!!". Hmm.

>get lamp
Taken.

>put flyer on table
(the poorly printed flyer on the dusty table)
You put the poorly printed flyer on the dusty table.

>look
ULU Entrance
ULU GROUND FLOOR DESCRIPTION.

In the foyer, you see a flimsy table - weighed down with a pile of retro-game flyers - that someone has attempted to make look dusty and old with the handicap of using only glitter, tinsel and coloured paper. 
Exits: north.

>put lamp onto table
You put the old lamp here on the dusty table.

>look
ULU Entrance
ULU GROUND FLOOR DESCRIPTION.

In the foyer, you see a flimsy table - weighed down with a pile of retro-game flyers - that someone has attempted to make look dusty and old with the handicap of using only glitter, tinsel and coloured paper.  Perched amongst the flyers, you see an old lamp.

Exits: north.

>x lamp
It looks like an old Davy lamp, covered with joke-shop cobwebs and glitter.

* * *

>take lamp
Taken.

>switch on lamp
You are in a brightly-lit area with no chance to be eaten by a grue. Besides, you have no fuel and nothing to lit it with.

>x lamp
It looks like an old Davy lamp, covered with joke-shop cobwebs and glitter.

* * *

>listen
You hear the a faint noise... did you just hear the word "xyzzy"? And how did you know that is how it is spelled? from the old lamp here.

* * *

>xyzzy
You close your eyes and gather your thoughts. You enunciate each syllable of the incantation well, only struggling to pronounce the second z clearly. 

You open your eyes, finding yourself to be exactly where you where. You haven't moved an inch, even though those around you may have taken a few steps away from you. 

The only effect of the spell you notice is that you now question your sanity.

* * *

>help
For those new to text adventures - Don't Panic! It's quite simple, once you get comfortable and learn that the flashing cursor is your friend.

All the action takes place in rooms. You can move from one room to another with a simple command like Go north or even just n. The game doesn't really care about the case of commands, so don't worry about that either. Many help pages online will use CAPITAL LETTERS to show things you type in, but it doesn't affect anything to use lower or even mixed-case.

Moving within a room isn't necessary - you don't need to approach a buffet table to take something from it - the game handles that sort of thing for you. Stick to short english commands and if you can see it, you can interact with it.

Compass directions are used to move around but the exits from a room are listed in this game, so you shouldn't have to make any maps. In fact, as this is based on the ULU venue itself, you might find decent maps of the place online!

Try to interact with your surroundings, for example:
> EXAMINE TABLE
> ASK BEN ABOUT PROGRAMMING LANGUAGES
> DRINK COFFEE
> READ FLYER
 and of course
> GET LAMP)

Other words to try:
PICK UP, PUT, DROP {something}, GET {something}, TAKE{something}
LOOK or EXAMINE {something}
INVENTORY
WAIT or Z

Many commands have abbreviated forms. You can use "X" instead of "EXAMINE", "I" instead of "INVENTORY", and the short-forms of the compass directions ("s","se", etc) to "GO" in that direction.

* * *

>x table
flimsy table - weighed down with a pile of retro-game flyers - that someone has attempted to make look dusty and old with the handicap of using only glitter, tinsel and coloured paper.

Perched amongst the flyers, you see an old lamp. For some reason, a slightly warped plastic arrow is also on the table. You also spot a red fish sprinkled with glitter. It is not obvious why someone has done this unless it's a desperate cry for help.

On the dusty table are an old lamp, a plastic arrow, a red fish, and a retro-game flyer pile.

* * *

>x lamp
It looks like an old Davy lamp, covered with joke-shop cobwebs and glitter.

>x table
On the dusty table are an old lamp and a retro-game flyer pile.

* * *

>x flyers
A stack of small pamphlets about the history of video games

>take flyer
You take one of the folded flyers from the over-flowing stack.

>take flyer
(the retro-game flyer pile)
You shouldn't take more than one, no matter how many there are here. These have obviously been printed on a student's budget!

>test table
(Testing.)

>[1] look
ULU Entrance
.

In the foyer, you see a flimsy table - weighed down with a pile of retro-game flyers - that someone has attempted to make look dusty and old with the handicap of using only glitter, tinsel and coloured paper.  Perched amongst the flyers, you see an old lamp.

Exits: north.

>[2] x table
A flimsy table - weighed down with a pile of retro-game flyers - that someone has attempted to make look dusty and old with the handicap of using only glitter, tinsel and coloured paper. Perched amongst the flyers, you see an old lamp.

On the dusty table are an old lamp and a retro-game flyer pile.

>[3] x glitter
Glitter. Wonderful. You look forward to finding little pieces of this stuck to you for many days to come.

>[4] x coloured paper
It's amazing what an artist can capture with just some scissors, glue and coloured paper. The person who decorated this table should've given them a call.

>[5] x tinsel
An unpleasant, gaudy and cheap-looking relic attached to the edges of the table in an effort to make it look more festive. You die a little inside.

>[6] x retro-game flyers
A stack of small pamphlets about the history of video games

>[7] take flyer
(the retro-game flyer pile)
You shouldn't take more than one, no matter how many there are here. These have obviously been printed on a student's budget!

>[8] x flyer
(the poorly printed flyer)
The title of the flyer is "GET LAMP - Interactive fiction in the 21st century!". Further down the page you see an apology for stealing the flyer's title from "Jason's (@textfiles) awesome upcoming documentary, can't wait!!!". Hmm.

>[9] x flyer
(the poorly printed flyer)
(An uninspiring photo of a smartphone running some sort of terminal application.) You guess this must be interesting for some reason you cannot fathom as the caption text under it uses a lot of exclamation marks.

>[10] x flyer
(the poorly printed flyer)
"Our Favourite Interactive Fiction games! (Check them out on IFDB) 

 - Blue Lacuna by Aaron A. Reed (Phenomenal!!)
 - Any and all of the Zork games
 - Vicious Cycles (http://bloomengine.com/cycles)
 - Photopia by Adam Cadre (strange and beautiful!)
 - Galatea by Emily Short
 - Ecdysis by Peter Nepstad (Very Non-PG Lovecraftian horror!)
 - Lost Pig by Admiral Jota (Grunk wants pig!)
 - Bronze by Emily Short (again)
 - Collosal Cave Adventure (a classic!!)
 (... the list goes on for most of a page, with names like Emily Short, Adam Cadre, Andrew Plotkin and Aaron Reed reoccurring a few times.) 

>[11] x flyer
(the poorly printed flyer)
You read a passage about how graphical interfaces destroy the imagination in children and adults. You stifle a laugh, knowing that whoever wrote this likely made it using MS Word. Mainly because of the overuse of Papyrus, Comic-sans and *scoff* Ariel.

I beg your pardon?

>n
Stairwell G
STAIRWELL G DESC.

Exits: south to ULU Entrance and up.

>u
Stairwell 1F
STAIRWELL 1F DESC.

Exits: down to Stairwell G, up, north and south.

* * *

>s
Corridor - Middle
REGISTRATION DESK CORRIDOR.

You can see a helpful woman here.

Exits: north to Stairwell 3F, west, southeast, southwest and east.

>se
You should really head to the Basecamp room before it's too late!

>sw
You should really head to the Basecamp room before it's too late!

>e
Corridor - East
corridor east.

Exits: west to Corridor - Middle, southeast and southwest.

* * *

>e
You can't go that way.

>w
Corridor - Middle
REGISTRATION DESK CORRIDOR.

You can see a helpful woman here.

Exits: north to Stairwell 3F, west, southeast, southwest and east to Corridor - East.

>w
Corridor - West
corridor west.

Exits: east to Corridor - Middle, west and south.

* * *

>n
Basecamp
BASECAMP DESC.

You can see a refreshments table (on which are a tea, a Coffee, a snack buffet, and a strange code fragment) here.

Exits: south to Corridor - Westmost.

Welcome.

I beg your pardon?

* * *

>z
Time passes.

If you haven't yet registered and picked up your Dev8D lanyard, please do so as soon as you can - it has your name on it!

>s
Corridor - Westmost
BASECAMP CORRIDOR.

Exits: east to Corridor - West and north to Basecamp.

* * *

>e
Corridor - West
corridor west.

Exits: east to Corridor - Middle, west to Corridor - Westmost and south.

>e
Corridor - Middle
REGISTRATION DESK CORRIDOR.

You can see a helpful woman here.

Exits: north to Stairwell 3F, west to Corridor - West, southeast, southwest and east to Corridor - East.

>se
3C
3C DESCRIPTION.

Exits: northwest to Corridor - Middle.

>nw
Corridor - Middle
REGISTRATION DESK CORRIDOR.

You can see a helpful woman here.

Exits: north to Stairwell 3F, west to Corridor - West, southeast to 3C, southwest and east to Corridor - East.

>sw
3D
3D DESCRIPTION.

You can see a simple desk (on which is a whirring laptop) and Ben O'Steen here.

Exits: northeast to Corridor - Middle.

>hi
(addressing Ben O'Steen)
You say hello to Ben O'Steen.

(You could ask him about Programming languages.)

>a languages
He replies "My favourite language to work in is python. I find it really readable and straightforward to get things done in.
"
(You could ask him about Python or Programming languages.)

>a python
"I think it's a wonderful language - whether it is the "best" one to learn is really dependent on what you want to get done but... I think it's one of the most fun!"

* * *

>rub lamp
Rubbing the old lamp is not particularly rewarding. Anyway, nothing exciting happens aside from your hands getting covered in fake spider web. But you tried, and that's the main thing.

[Your score has just gone up by one point.]

* * *

>showme arrow
plastic arrow - thing
location: on the dusty table in ULU Entrance
singular-named, improper-named; unlit, inedible, portable, neuter, unmarked for special listing, ordinarily enumerated, seen, unfamiliar, keyworded
printed name: "plastic arrow"
printed plural name: none
indefinite article: none
description: "A toy arrow that might be made out of a spongy plastic foam, like that used to cover bats to make them "safe". It's a dismal grey in colour, with a few dark squiggles along one side.."
initial appearance: none
keyword: none
sound: "silence"

>showme old lamp
old lamp - thing
location: on the dusty table in ULU Entrance
singular-named, improper-named; unlit, inedible, portable, neuter, unmarked for special listing, ordinarily enumerated, seen, unfamiliar, keyworded
printed name: "old lamp"
printed plural name: none
indefinite article: none
description: "It looks like an old Davy lamp, covered with joke-shop cobwebs and glitter."
initial appearance: none
keyword: none
sound: "a faint noise... the word "xyzzy" crosses your mind but you don't know why."

* * *

>version
Dev8D
A day at Dev8D by Ben O'Steen
Release 1 / Serial number 120106 / Inform 7 build 6G60 (I6/v6.32 lib 6/12N) SD
Identification number: //A643D806-3501-11E1-99A2-78843CCE3727//
Standard interpreter 1.1 (1F) / Library serial number 080126
Standard Rules version 2/090402 by Graham Nelson
Keywords for Conversation version 2 by Matt Wigdahl
Exit Descriptions version 2 by Matthew Fletcher
Conversation Package version 2 by Eric Eve
Keyword Interface version 8 by Aaron Reed
Conversation Nodes version 6 by Eric Eve
Conversation Suggestions version 5 by Eric Eve
Conversation Responses version 5 by Eric Eve
Conversational Defaults version 2 by Eric Eve
Conversation Framework version 9 by Eric Eve
Epistemology version 6 by Eric Eve

* * *

>x students
Many have lit cigarettes, held in a variety of different manners. Those that do not are either using their phones, chatting or standing around waiting for a cigarette to be offered to them.

* * *

>x fish
Fishy and obligatory.

>x fish
Fishy and obligatory.

>push fish
Nothing obvious happens.

>pull fish
Nothing obvious happens.

>take fish
This is not useful. Honest.

>take fish
It's red and a fish. That should be hint enough.

>smell lamp
You smell nothing unexpected.

>listen to lamp
From the old lamp you hear a faint noise... the word "xyzzy" crosses your mind but you don't know why..

>get lamp
Taken.

>n
Stairwell G
STAIRWELL G DESC.

Exits: south to ULU Entrance and up.

* * *

>u
Stairwell 3F
STAIRWELL 3F DESC.

Exits: down to Stairwell 1F and south.

>drop lamp
Dropped.

>look
Stairwell 3F
STAIRWELL 3F DESC.

You can see an old lamp here.

Exits: down to Stairwell 1F and south.

>listen
You hear some sounds in this room, but you can't make out what is causing it.

>take lamp
Taken.

>s
Corridor - Middle
REGISTRATION DESK CORRIDOR.

You can see a helpful woman here.

Exits: north to Stairwell 3F, west, southeast, southwest and east.

>e
Corridor - East
corridor east.

Exits: west to Corridor - Middle, southeast and southwest.

>w
Corridor - Middle
REGISTRATION DESK CORRIDOR.

You can see a helpful woman here.

Exits: north to Stairwell 3F, west, southeast, southwest and east to Corridor - East.

>sw
You should really head to the Basecamp room before it's too late!

* * *

>se
You should really head to the Basecamp room before it's too late!

>w
Corridor - West
corridor west.

Exits: east to Corridor - Middle, west and south.

* * *

>n
Basecamp
BASECAMP DESC.

You can see a refreshments table (on which are a tea, a Coffee, a snack buffet, and a strange code fragment) here.

Exits: south to Corridor - Westmost.

Welcome.

>fragment
A piece of paper, torn off from a larger piece. It is covered in lots of lower-case letters, arranged mostly as a block of characters with a fixed spacing between characters reminiscent of a computer terminal.
----------------------------

zqkszwtt

vmdmzowvvioqdmgwccxv
mdmzowvvitmbgwclwevv
mdmzowvvizcvizwcvliv
llmamzbgwcvmdmzowvvi
uismgwckzgvmdmzowvvi
aigowwljgmvmdmzowvvi
bmttitqmivlpczbgwc

----------------------------

Odd.

2nd line.

>fragment
A piece of paper, torn off from a larger piece. It is covered in lots of lower-case letters, arranged mostly as a block of characters with a fixed spacing between characters reminiscent of a computer terminal.
----------------------------

zqkszwtt

vmdmzowvvioqdmgwccxv
mdmzowvvitmbgwclwevv
mdmzowvvizcvizwcvliv
llmamzbgwcvmdmzowvvi
uismgwckzgvmdmzowvvi
aigowwljgmvmdmzowvvi
bmttitqmivlpczbgwc

----------------------------

Odd.

If you haven't yet registered and picked up your Dev8D lanyard, please do so as soon as you can - it has your name on it!

* * *

>arrow
A toy arrow that might be made out of a spongy plastic foam, like that used to cover bats to make them "safe". It's a dismal grey in colour, with a few dark squiggles along one side..

>lamp
It looks like an old Davy lamp, covered with joke-shop cobwebs and glitter.

>lamp
 It looks like it hasn't been lit in very long time. You notice a small plaque around the bottom edge of the lamp

>lamp
You are able to rub some debris from the plaque, revealing this message: "For use when presented by a maze of twisty little passages, all alike".

>x glitter
Glitter. Wonderful. You look forward to finding little pieces of this stuck to you for many days to come.

* * *

>look
ULU Entrance

A flimsy table - weighed down with a pile of retro-game flyers - that someone has attempted to make look dusty and old with the handicap of using only glitter, tinsel and coloured paper.

Perched amongst the flyers, you see an old lamp. For some reason, a slightly warped plastic arrow is also on the table. You also spot a red fish sprinkled with glitter. It is not obvious why someone has done this unless it's a desperate cry for help.
Exits: north.

* * *

>sign
The posted has the familiar orange logo for Dev8D on it, and an arrow pointing up. Simple, and straightforward.

>look
ULU Entrance

You see a flimsy, trestle table - weighed down with a pile of retro-game flyers - that someone has attempted to make look dusty and old with the handicap of using only glitter, tinsel and coloured paper.

Perched amongst the flyers, you see an old lamp. For some reason, a slightly warped plastic arrow is also on the table. You also spot a red fish sprinkled with glitter. It is not obvious why someone has done this unless it's a desperate cry for help.

Exits: north.

* * *

>keycard
A shiny, laminated keycard. Oh, and it's also red, which is probably important.

>keycard
A red, shiny keycard.

>take keycard
Really? You think that stealing that is going to help you later? That keycard belongs to someone. It's probably their library card or something.

>take keycard
No.

>take keycard
*sigh*.

>take keycard
THIEF! Stop THIEF!

(No, not really, but you need to curb that kleptomania before you start hearing this on a regular basis).

I beg your pardon?

>look under table
You find the hidden-under-the-table notice!

>read notice
"The Desk of Obligatory Tropes"
 by Roy G. Biv.

(Ah, go on. Have a point.)

[Your score has just gone up by one point.]

>read notice
"The Desk of Obligatory Tropes"
 by Roy G. Biv.

>n
Ground floor stairs
In the low-light of the stairwell, you see a set of sharp-angled stairs spiralling upwards, fenced in by a utilitarian handrail, supported by thin banisters. The parts of the walls you can see are the kind of beige colour that cannot be described accurately without the words "institutional" and "depressing". It won't be how the colour is officially labelled, but labels are rarely honest. The noise from the rest of the building provides a background hum of activity. 

The only way is UP! or something like that. 

There is a message board lining the walls of the stairwell.

Exits: south to ULU Entrance and up.

>u
First floor stairs
A spiralling staircase, hemmed in by harsh railings and beige walls. The noise from the rest of the building provides a background hum of activity.

You see that the Gallery bar is north through the double doors, but now is no time to take a drink. You can go down to the ground floor or up a few flights to the third floor, which is where most of Dev8D will take place.

Exits: down to Ground floor stairs, up, north and south.

* * *

>u
Third floor stairs
A spiralling staircase, hemmed in by harsh railings and beige walls. The noise from the rest of the building provides a background hum of activity.

Exits: south and down to First floor stairs.

>s
Corridor - Middle
REGISTRATION DESK CORRIDOR.

You can see a helpful woman here.

Exits: west, north to Third floor stairs, southeast, southwest and east.

>w
Corridor - West
corridor west.

Exits: east to Corridor - Middle, west and south.

* * *

>w
Corridor - Westmost
BASECAMP CORRIDOR.

Exits: east to Corridor - West and north.

>nm
That noun did not make sense in this context.

>n
Basecamp

Exits: south to Corridor - Westmost.

You enter the door and come face-to-face (well, face-to-back) with a crowd of people, all of whom are looking intently towards the other side of the room. It seems that things are just about to start, so you press forward to get a decent enough view. You manoeuvre through the throng of developers, hackers, academics and other delegates as politely as you can until you manage to get a view of the organiser who is just about to speak.

"Welcome! Thank you all for coming to this, the fourth Dev8D! Yes, fourth! I'm so glad to see lots of new faces out there, standing amongst the faces I already know well! You know, helping people meet up and talk about the things that interest or even stump you is one of the key reasons this event exists. Many of you work in small teams and can feel isolated. Sometimes you alone are the team!"

You hear quite a few knowing laughs from the people in the crowd. Seems you aren't alone here after all.

* * *

>z
Time passes.

He continues: "

>x crowd
You can see people all around you, standing shoulder to shoulder.

If you haven't yet registered and picked up your Dev8D lanyard, please do so as soon as you can - it has your name on it!

>x crowd of people
You can't see any such thing.

>z
Time passes.

* * *

>s
Corridor - Westmost
BASECAMP CORRIDOR.

Exits: east to Corridor - West and north to Basecamp.

>n
Basecamp
Normal BASECAMP DESC.

You can see a refreshments table (on which are a tea, a Coffee, a snack buffet, and a strange code fragment) and a Basecamp schedule board here.

Exits: south to Corridor - Westmost.

>s
Corridor - Westmost
BASECAMP CORRIDOR.

Exits: east to Corridor - West and north to Basecamp.

* * *

>e
Corridor - West
corridor west.

Exits: east to Corridor - Middle, west to Corridor - Westmost and south.

>sw
You can't go that way.

>e
Corridor - Middle
REGISTRATION DESK CORRIDOR.

You can see a helpful woman here.

Exits: west to Corridor - West, north to Third floor stairs, southeast, southwest and east.

>sw
3D
3D DESCRIPTION.

You can see a simple desk (on which is a whirring laptop) and Ben O'Steen here.

Exits: northeast to Corridor - Middle.

>ne
Corridor - Middle
REGISTRATION DESK CORRIDOR.

You can see a helpful woman here.

Exits: west to Corridor - West, north to Third floor stairs, southeast, southwest to 3D and east.

>se
3C
3C DESCRIPTION.

Exits: northwest to Corridor - Middle.

>nw
Corridor - Middle
REGISTRATION DESK CORRIDOR.

You can see a helpful woman here.

Exits: west to Corridor - West, north to Third floor stairs, southeast to 3C, southwest to 3D and east.

>go to 3d
You can't see any such thing.

>sw
3D
3D DESCRIPTION.

You can see a simple desk (on which is a whirring laptop) and Ben O'Steen here.

Exits: northeast to Corridor - Middle.

>tell ben about rickroll
Ben O'Steen does not respond.

>hi
You are already talking to Ben O'Steen.

>tell ben about rickroll
Ben O'Steen does not respond.

>topics
You could ask him about Programming languages.

>languages
He replies "To be honest, they are all the same. Pick one, learn it by writing actual code and most importantly, learn its libraries and how the community works. I have to say though, I have a real soft spot for python. Does the job, clear, easy, nice. It makes me weep to have to work with some horrid thing like Java again. Everything is unfortunately named, I mean, "Maven"? Never used a build system that required more faff to get working. Should've called it "N00b" not "Maven". Well, actually, come to think of it, ruby's gem system is bloody fragile too... Well, they all suck really, but at various levels of "suckage"."

(You could ask him about Python, Ruby, Java, Maven, or Programming languages.)

>languages
He replies "To be honest, they are all the same. Pick one, learn it by writing actual code and most importantly, learn its libraries and how the community works. I have to say though, I have a real soft spot for python. Does the job, clear, easy, nice. It makes me weep to have to work with some horrid thing like Java again. Everything is unfortunately named, I mean, "Maven"? Never used a build system that required more faff to get working. Should've called it "N00b" not "Maven". Well, actually, come to think of it, ruby's gem system is bloody fragile too... Well, they all suck really, but at various levels of "suckage"."

(You could ask him about Python, Ruby, Java, Maven, or Programming languages.)

I beg your pardon?

>python
"I think it's a wonderful language - whether it is the "best" one to learn is really dependent on what you want to get done but I think it's a great way to start."

>ruby
"Ruby, yep, a fine choice of language, lots of shiny things going on with that and in that community. Not my cup of tea though, too much punctuation and odd phrasings for me."

>maven
Thanks, but no thanks.

>java
He turns, looking you in the eye. "Yes, I know it's an "enterprisey" language and makes you as employable as with any other language, but nowadays, I find the idea of working within an existing Java codebase as pleasant as a herniated disc - Don't get me wrong, I have the experience to make a good job of it, but it really bloody hurts my brain, there is often a quicker way to get the job done and I can think of thousands of better things to do with my time. And what with Oracle buying Sun and Java last year, and then doing their usual "tricks" with the acquired technology... yeah, let's just say Java is fine, but not for me."

>bye
You say goodbye to Ben O'Steen.

>ne
Corridor - Middle
REGISTRATION DESK CORRIDOR.

You can see a helpful woman here.

Exits: west to Corridor - West, north to Third floor stairs, southeast to 3C, southwest to 3D and east.

>w
Corridor - West
corridor west.

Exits: east to Corridor - Middle, west to Corridor - Westmost and south.

* * *

>w
Corridor - Westmost
BASECAMP CORRIDOR.

Exits: east to Corridor - West and north to Basecamp.

>n
Basecamp
Normal BASECAMP DESC.

You can see a refreshments table (on which are a tea, a Coffee, a snack buffet, and a strange code fragment) and a Basecamp schedule board here.

Exits: south to Corridor - Westmost.

>fragment
A piece of paper, torn off from a larger piece. It is covered in lots of lower-case letters, arranged mostly as a block of characters with a fixed spacing between characters reminiscent of a computer terminal. It reminds you of the sort of paper receipts are printed on. There is an odd mark on the back of the paper which looks a little like a snake.
----------------------------

zqkszwtt

vmdmzowvvioqdmgwccxv
mdmzowvvitmbgwclwevv
mdmzowvvizcvizwcvliv
llmamzbgwcvmdmzowvvi
uismgwckzgvmdmzowvvi
aigowwljgmvmdmzowvvi
bmttitqmivlpczbgwc

----------------------------

Odd.

>fragment
----------------------------

zqkszwtt

vmdmzowvvioqdmgwccxv
mdmzowvvitmbgwclwevv
mdmzowvvizcvizwcvliv
llmamzbgwcvmdmzowvvi
uismgwckzgvmdmzowvvi
aigowwljgmvmdmzowvvi
bmttitqmivlpczbgwc

----------------------------

>take fragment
You take the paper, but at a glance you can tell that it is encrypted - you can't tell if it will contain important information or a recipe for good caesar salad. Actually, maybe it is worth decoding then.

>s
Corridor - Westmost
BASECAMP CORRIDOR.

Exits: east to Corridor - West and north to Basecamp.

* * *

>e
Corridor - West
corridor west.

Exits: east to Corridor - Middle, west to Corridor - Westmost and south.

>e
Corridor - Middle
REGISTRATION DESK CORRIDOR.

You can see a helpful woman here.

Exits: west to Corridor - West, north to Third floor stairs, southeast to 3C, southwest to 3D and east.

>sw
3D
3D DESCRIPTION.

You can see a simple desk (on which is a whirring laptop) and Ben O'Steen here.

Exits: northeast to Corridor - Middle.

>show ben the fragment
"You found one of my ciphers! Have you solved it yet? Do you get it?" he asks.

>tell ben rickroll
Ben O'Steen does not respond.

>tell ben about rickroll
He smiles, looking at the code fragment you are carrying. "Nice little cipher to start the day with, eh?"

[Your score has just gone up by five points.]

>rickroll
He looks quizzically at you. "Yes, you've worked it out. Well done, but I heard you the first time.

I beg your pardon?

>ask about rickroll
He looks quizzically at you. "Yes, you've worked it out. Well done, but I heard you the first time.

>score
You have so far scored 6 out of a possible 0, in 59 turns.

>score
You have so far scored 6 out of a possible 0, in 59 turns.

>ask about rickroll
He looks quizzically at you. "Yes, you've worked it out. Well done, but I heard you the first time.

>score
You have so far scored 6 out of a possible 0, in 60 turns.

>x laptop
This poor machine is obviously doing 8 things at the same time from the noise it's making. That, or just that it really needs to be cleaned. You recognise a logo on the screen as being the same as that you found on the code fragment.

* * *

>showme event delegates
I only understood you as far as wanting to showme Event Area.

I beg your pardon?

>take pile
You take one of the folded flyers from the over-flowing stack.

>take pile
You shouldn't take more than one, no matter how many there are here. These have obviously been printed on a student's budget!

>showme Main Stairwell
Main Stairwell - backdrop
location: out of play
singular-named, improper-named; unlit, inedible, fixed in place, scenery, neuter, unmarked for special listing, ordinarily enumerated, unseen, unfamiliar, keywordless, used
printed name: "Main Stairwell"
printed plural name: "backdrops"
indefinite article: none
description: none
initial appearance: none
keyword: none
sound: "Chattering voices from all floors are funnelled and compressed together with the footsteps of people in this stairwell. The sounds bounce and rebound along the walls, turning into a generic murmur of activity, with no one sound being distinguishable from the next."
smell: "nothing"

>n
Ground floor stairs
In the low-light of the stairwell, you see a set of sharp-angled stairs spiralling upwards, fenced in by a utilitarian handrail, supported by thin banisters. The parts of the walls you can see are the kind of beige colour that cannot be described accurately without the words "institutional" and "depressing". It won't be how the colour is officially labelled, but labels are rarely honest. The noise from the rest of the building provides a background hum of activity. 

The only way is UP! or something like that. 

There is a message board lining the walls of the stairwell.

Exits: up and south to ULU Entrance.

>showme Main Stairwell
Main Stairwell - backdrop
location: in Ground floor stairs
singular-named, improper-named; unlit, inedible, fixed in place, scenery, neuter, unmarked for special listing, ordinarily enumerated, unseen, unfamiliar, keywordless, used
printed name: "Main Stairwell"
printed plural name: "backdrops"
indefinite article: none
description: none
initial appearance: none
keyword: none
sound: "Chattering voices from all floors are funnelled and compressed together with the footsteps of people in this stairwell. The sounds bounce and rebound along the walls, turning into a generic murmur of activity, with no one sound being distinguishable from the next."
smell: "nothing"

I beg your pardon?

>u
First floor stairs
A spiralling staircase, hemmed in by harsh railings and beige walls. The noise from the rest of the building provides a background hum of activity.

You see that the Gallery bar is north through the double doors, but now is no time to take a drink. You can go down to the ground floor or up a few flights to the third floor, which is where most of Dev8D will take place.

Exits: down to Ground floor stairs, up, north and south.

>s
Duck & Dive Bar
Duck and Dive bar description.

Exits: north to First floor stairs.

* * *

>w
You can't go that way.

>n
First floor stairs
A spiralling staircase, hemmed in by harsh railings and beige walls. The noise from the rest of the building provides a background hum of activity.

You see that the Gallery bar is north through the double doors. You can go down to the ground floor or up a few flights to the third floor.

Exits: down to Ground floor stairs, up, north and south to the Duck & Dive Bar.

>u
Third floor stairs
A spiralling staircase, hemmed in by harsh railings and beige walls. The noise from the rest of the building provides a background hum of activity.

Exits: south and down to First floor stairs.

* * *

>w
Corridor - Westmost
BASECAMP CORRIDOR.

Exits: east to Corridor - West and north.

>n
Basecamp
You enter the door and come face-to-face (well, face-to-back) with a crowd of people, all of whom are looking intently towards the other side of the room.

Exits: south to Corridor - Westmost.

It seems that things are just about to start, so you press forward to get a decent enough view. You manoeuvre through the throng of developers, hackers, academics and other delegates as politely as you can until you manage to get a view of the organiser who is just about to speak.

"Welcome! Thank you all for coming to this, the fourth Dev8D! Yes, fourth! I'm so glad to see lots of new faces out there, standing amongst the faces I already know well! You know, helping people meet up and talk about the things that interest or even stump you is one of the key reasons this event exists. Many of you work in small teams and can feel isolated. Sometimes you alone are the team!"

You hear quite a few knowing laughs from the people in the crowd. Seems you aren't alone here after all.

>z
Time passes.

He continues: "

>z
Time passes.

If you haven't yet registered and picked up your Dev8D lanyard, please do so as soon as you can - it has your name on it!

Basecamp
Normal BASECAMP DESC.

You can see a refreshments table (on which are a tea, a Coffee, a snack buffet, and a strange code fragment) and a Basecamp schedule board here.

Exits: south to Corridor - Westmost.

>z
Time passes.

>take fragment
You take the paper, but at a glance you can tell that it is encrypted - you can't tell if it will contain important information or a recipe for good caesar salad. Actually, maybe it is worth decoding then.

>z
Time passes.

>look
Basecamp
Normal BASECAMP DESC.

You can see a refreshments table (on which are a tea, a Coffee, and a snack buffet) and a Basecamp schedule board here.

Exits: south to Corridor - Westmost.

* * *

>smell the fish
Awful. Just... awful. And now you have got glitter on your cheek. Congratulations..

>smell the keycard
You try to smell the keycard, but it's too close to the rotting fish for you to smell anything else. It probably smells like its owner's wallet anyhow. 

Well, it did until it was pushed underneath that fish.

>pull keycard
Really? You think that stealing that is going to help you later? That keycard belongs to someone. It's probably their library card or something.

I beg your pardon?

>take a flyer
You take one of the folded flyers from the over-flowing stack.

>look
ULU Entrance
The shop is still closed it seems and the Sisyphean challenge of keeping the bar stocked with booze and J20 is still ongoing. Students are quietly working and chatting in the seated area.

You see an unmanned trestle table sagging with the weight of a huge pile of flyers. Someone has attempted to make the table and everything on it look old and dusty, but with the handicap of using only glitter, tinsel and coloured paper.

Nestled amongst the flyers, is an old lamp. Unlike most of the other items on the table, the lamp looks old simply because it is. For some reason, a slightly warped plastic arrow is also on the table. You also spot a red fish sprinkled with glitter on the table as well. Why someone would use so much glitter isn't obvious, unless it's a thinly-veiled cry for help. A shiny red keycard pokes out from underneath the fish. You note that it has somehow remained glitter-free.

You can see a dusty table (on which are an old lamp, a red fish, a shiny red keycard, and a pile of flyers) here.

Exits: north.

>read flyer
(the poorly printed flyer)
The title of the flyer is "GET LAMP - Interactive fiction in the 21st century!". Further down the page you see an apology for stealing the flyer's title from "Jason's (@textfiles) awesome upcoming documentary, can't wait!!!". Hmm.

>eat flyer
(the poorly printed flyer)
That's plainly inedible.

>throw flyer
(the poorly printed flyer)
Dropped.

>take flyer
(the poorly printed flyer)
Taken.

>throw flyer at fish
(the poorly printed flyer at the red fish)
Futile.

>n
Ground floor stairs
In the low-light of the stairwell, you see a set of sharp-angled stairs spiralling upwards, fenced in by a utilitarian handrail, supported by thin banisters. The parts of the walls you can see are the kind of beige colour that cannot be described accurately without the words "institutional" and "depressing". It won't be how the colour is officially labelled, but labels are rarely honest. The noise from the rest of the building provides a background hum of activity. 

The only way is UP! or something like that. 

There is a message board lining the walls of the stairwell.

Exits: up and south to ULU Entrance.

>up
First floor stairs
A spiralling staircase, hemmed in by harsh railings and beige walls. The noise from the rest of the building provides a background hum of activity.

You see that the Gallery bar is north through the double doors, but now is no time to take a drink. You can go down to the ground floor or up a few flights to the third floor, which is where most of Dev8D will take place.

Exits: down to Ground floor stairs, up, north and south.

>astract me to the venue
That noun did not make sense in this context.

>abstract me to the venue
[Abstracted.]

>look
The Venue
In the Venue you can see ARDrone and Dave Tarrant.

Exits: down to Ground floor stairs, up, north and south.

The ARDrone swoops past your head.

>look
The Venue
In the Venue you can see ARDrone and Dave Tarrant.

Exits: down to Ground floor stairs, up, north and south.

The ARDrone swoops past your head.

>abstract me to 3c
[Abstracted.]

I beg your pardon?

>look
3C
In 3C you can see Graham Klyne.

Exits: down to Ground floor stairs, up, north and south.

>look
3C
In 3C you can see Graham Klyne.

Exits: down to Ground floor stairs, up, north and south.

* * *

>abstract me to 3D
[Abstracted.]

>hi
(addressing Ben O'Steen)
You address the coder.  "Hi!"

"Hello!  What do you want to talk about?"

(You could ask him about Programming languages.)

>a languages
You remember back to the orientation talk. "I'm not sure what language I should go for at lunch. What do you think?" you ask.

He shrugs his shoulders a little. "To be honest, they are all pretty much the same. Pick one, learn it by writing actual code and most importantly, find out about the libraries you should use and more importantly, the libraries you shouldn't. The best way you can do that is by chatting with your peers - you know, the people like you, doing similar things to you. You can learn the most from them."

He turns back to his laptop and opens yet another terminal on the screen - you could've sworn you heard the laptop's fans sigh audibly. He brings up a python prompt and turns back to you. 

"I have to say though, I have a real soft spot for python. Does the job, clear, easy, nice. Well worth putting time in learning. There's also javascript, which is a crucial language to know if you are building a web service."

(You could ask him about Python, Javascript, or Programming languages.)

>python
You ask "So... if I wanted to learn about python and its libraries and stuff...?"

"Google it" he replies with a smile. He continues to type into one of the many terminal windows on his screen.

"Er... okay." You had thought he would help a little more than that. You turn to leave.

"Wait! I'm kidding!" he says. "Ordinarily I'd tell you to search for that online, as you'll find some of the best material there, like "Dive into Python", but look around you. There's a ton of collective python experience here, the kind of experience that make the difference between searching for hours or having an issue sorted out with a quick chat." He "alt-tab's back to a browser window. "In fact, I think there is a python workshop due to start soon if you are keen. It's taking place next door in room 3B. Just remember, it's the community of people that makes a language great, not the other way around. Ask questions, get involved. As with anything, you get out from it more than what you put it, but you have to put something in first!"

>python
You ask about python again. He raises an eyebrow "Have you checked next door yet?"

>cryptography
There is no reply.

>a cryptography
"Er... what?

(You could ask him about Python, Javascript, or Programming languages.)

>abstract strange code fragment to me
[Abstracted.]

>x fragment
A piece of paper, torn off from a larger piece. It is covered in lots of lower-case letters, arranged mostly as a block of characters with a fixed spacing between characters reminiscent of a computer terminal. It reminds you of the sort of paper receipts are printed on. There is an odd mark on the back of the paper which looks a little like a snake.
----------------------------

zqkszwtt

vmdmzowvvioqdmgwccxv
mdmzowvvitmbgwclwevv
mdmzowvvizcvizwcvliv
llmamzbgwcvmdmzowvvi
uismgwckzgvmdmzowvvi
aigowwljgmvmdmzowvvi
bmttitqmivlpczbgwc

----------------------------

Odd.

>x fragment
----------------------------

zqkszwtt

vmdmzowvvioqdmgwccxv
mdmzowvvitmbgwclwevv
mdmzowvvizcvizwcvliv
llmamzbgwcvmdmzowvvi
uismgwckzgvmdmzowvvi
aigowwljgmvmdmzowvvi
bmttitqmivlpczbgwc

----------------------------

>show fragment to ben
You show the code fragment to him. 

He looks at it and his eyes widen a little. "Ah, yeah, that. It's a bit of a joke really! Have you solved it? Do you get it?" he asks.

>a crypto
"Advanced cryptography sounds fun. How about that?" you ask.

"You remember when I told you to google python? Yeah, well, there is a huge amount to modern cryptography and it's hard to explain without some preparation. I could ask around for you to see if there is someone willing to do a Lightning talk on cryptography, I'm sure there'd be interest in something like that. You could ask around too, you know. There's plenty of flexibility in the schedule later on as we purposefully left space for this sort of thing.

>a cryptography
"Er... what?

(You could ask him about Python, Codebreaking, Javascript, or Programming languages.)

>a codebreaking
He looks up at the mention of codebreaking. "It would be cool if someone did a lightning talk or session on that! What do you want to know about it? Do you know about the simple stuff like caesar ciphers or more advanced crypto?"

(You could ask him about Python, Caesar cipher, Advanced crypto, Javascript, or Programming languages.)

>a caesar
"What about the Caesar cipher? How does that work?" you ask. 

"It's a very simple code. Here, let me show you." he says, turning the laptop towards you. "Imagine the alphabet you want to use written out twice, one row above another. For example:" 

(on screen)
A B C D E F G H I...
A B C D E F G H I...

By shifting the second row to the right or left by some number of letters, say, 3 letters to the right, you can create a caesar cipher encoder:

A B C D E F G H I...
X Y Z A B C D E F...

He points to the screen "Note how the letters wrap around here. To encode a letter, you find it on the top row and use the letter under it. In this way, BED becomes YBA, HAG becomes EXD and so on. ROT 13  or "rotate by 13" is a well known variation on the caesar cipher. Pretty easy to code this in python too.
"
(You could ask him about Python, Caesar cipher, Advanced crypto, ROT code, Javascript, or Programming languages.)

>a caesar
You ask again about the Caesar cipher. 

"Turn your letters into numbers, add or subtract to them and then turn them back to text. Nothing more to it than that really." he says with a shrug.

(You could ask him about Python, Caesar cipher, Advanced crypto, ROT code, Javascript, or Programming languages.)

>a crypto
"Would you run a session on advanced cryptography or ciph..."

He cuts in before you can finish. "Sorry, not today, I've already got most of the day booked up. Besides, I'm sure there are a lot of other people who are far more qualified. I hope you can find someone to talk to about it."

>a python
You ask about python again. He raises an eyebrow "Have you checked next door yet?"

>languages
You ask him again about programming languages. 

"Well, I'm not sure what else you want - I've already told you that python and javascript are worth learning. You don't have to choose one at lunch. If the conversation isn't helping you then get up and try a different table." 
(You could ask him about Python, Caesar cipher, Advanced crypto, ROT code, Javascript, or Programming languages.)

>code
(the strange code fragment)

>ask about code
(the strange code fragment)
You show the code fragment to him. 

He looks at it and his eyes widen a little. "Ah, yeah, that. It's a bit of a joke really! Have you solved it? Do you get it?" he asks.

>a ROT
Ben's stomach rumbles loudly. He says "Sorry, I'm starving. Let me finished this code so I can get some food from the Basecamp.

>abstract me to ULU Entrance
[Abstracted.]

I beg your pardon?

>take lamp
Taken.

>z
Time passes.

>z
Time passes.

"Hey!" An angry man shouts out at you. "That's my lamp! What the hell do you think you are playing at? Give it here!" He snatches the old lamp from you, and looks like he is about to erupt. Eventually, he gets himself under control and just shakes his head in frustration at you and stalks off, the lamp swinging beside him.

>take lamp
Taken.

* * *

>z
Time passes.

>z
Time passes.

You are tapped on the shoulder twice, with some force behind each tap. 

You turn round to see the angry man from before "You again?" he says "That lamp is an heirloom, it's not worth anything to anyone but me, so leave off!" He grabs the lamp and walks off

>z
Time passes.

>take lamp
Taken.

* * *

>z
Time passes.

>z
Time passes.

You are slammed to the floor by something big. You roll over but see nothing.

>look
ULU Entrance
The shop is still closed it seems and the Sisyphean challenge of keeping the bar stocked with booze and J20 is still ongoing. Students are quietly working and chatting in the seated area.

You see an unmanned trestle table sagging with the weight of a huge pile of flyers. Someone has attempted to make the table and everything on it look old and dusty, but with the handicap of using only glitter, tinsel and coloured paper.

Nestled amongst the flyers, is an old lamp. Unlike most of the other items on the table, the lamp looks old simply because it is. For some reason, a slightly warped plastic arrow is also on the table, positioned as if it is important. There is a red fish almost buried in glitter next to it on the table. Why someone would use so much glitter isn't obvious, unless they are doing it as a (thinly-veiled) cry for help. A shiny red keycard pokes out from underneath the fish. You note that it has somehow remained glitter-free.

You can see a dusty table (on which is a pile of flyers) here.

Exits: north.

>touch arrow
Ew. The plastic is tacky and looks like it is decomposing from age. You'd rather not do that at all.

>lick arrow
Ew. The plastic is tacky and looks like it is decomposing from age. You'd rather not do that at all.

>x arrow
A toy arrow that might be made out of a spongy plastic foam, like that used to cover bats to make them "safe". It's a dismal grey in colour, with a few dark squiggles along one side..

>x arrow
You look at the dark squiggles more closely. You discover that if you angle yourself just so that you can make out the faded words that run along one side of the arrow: 

Guaranteed to kill 99.91f grues!
(Note: Dye used in this recreational toy is toxic. Not safe for children under 3 years of age. Does not kill grues. Use at own risk.)".

>x arrow
You look at the dark squiggles more closely. You discover that if you angle yourself just so that you can make out the faded words that run along one side of the arrow: 

Guaranteed to kill 99.91f grues!
(Note: Dye used in this recreational toy is toxic. Not safe for children under 3 years of age. Does not kill grues. Use at own risk.)".

>smell arrow
Ew. The plastic is tacky and looks like it is decomposing from age. You'd rather not do that at all.

* * *

>abstract me to 3D
[Abstracted.]

>3D
Which do you mean, 3D or the 3D printer?

* * *

>abstract me to 3D
[Abstracted.]

>abstract me to 3D printer
I only understood you as far as wanting to abstract yourself to 3D.

>look
3D
In 3D you can see Graham Klyne, a large project desk, an electronics desk, a small project desk (on which is a whirring laptop), and Ben O'Steen.

Exits: north.

>x large project desk
You see nothing special about the large project desk.

>x charis
You can't see any such thing.

>sit in chairs
You can't see any such thing.

>x chairs
You can't see any such thing.

>x developers
You can't see any such thing.

>abstract me to Basecamp
[Abstracted.]

>abstract me to Basecamp
[Abstracted.]

>abstract me to Basecamp.
[Abstracted.]

>x developers
You can't see any such thing.

>look
Basecamp
Exits: north.

It seems that things are just about to start, so you press forward to get a decent enough view. You manoeuvre through the throng of developers, hackers, academics and other delegates as politely as you can until you manage to get a view of the organiser who is just about to speak.

"Welcome! Thank you all for coming to this, the fourth Dev8D! Yes, fourth! I'm so glad to see lots of new faces out there, standing amongst those I already know! Helping people meet up and talk about the things that interest or even stump you is one of the key reasons this event exists. Many of you work in small teams and can feel isolated. Sometimes you alone are the team!"

You hear quite a few knowing laughs from the people in the crowd. Seems you aren't alone here after all.

>look
You should listen for a little while. It's only polite after all. (Type "wait" or "z" to skip on through the speech.)

He continues: "

>look
You should listen for a little while. It's only polite after all. (Type "wait" or "z" to skip on through the speech.)

If you haven't yet registered and picked up your Dev8D lanyard, please do so as soon as you can - it has your name on it!

Basecamp
In Basecamp you can see a refreshments table (on which are coffee, tea, a snack buffet, and a strange code fragment) and a Schedule board.

Exits: north.

>x developers
You can't see any such thing.

>showme developers
developers - backdrop
location: out of play
singular-named, improper-named; unlit, inedible, fixed in place, scenery, neuter, unmarked for special listing, ordinarily enumerated, unseen, unfamiliar, keywordless, used
printed name: "developers"
printed plural name: "backdrops"
indefinite article: none
description: "On one table, you see someone chatting to a small group of others, gesticulating towards a large diagram they've stuck to the wall. From what you can make out, she is explaining how she has been using message queueing in her services."
initial appearance: none
keyword: none
sound: "silence"
smell: "nothing"

>n
You can't go that way.

>s
Corridor - Westmost
BASECAMP CORRIDOR.

Exits: east and north.

A small group of students, talking loudly, pass you on their way to the stairs.

>n
Basecamp
You enter the door and come face-to-face (well, face-to-back) with a crowd of people, all of whom are looking intently towards the other side of the room.

You can see a refreshments table (on which are coffee, tea, a snack buffet, and a strange code fragment) and a Schedule board here.

Exits: south to Corridor - Westmost.

>showme developers
developers - backdrop
location: in Basecamp
singular-named, improper-named; unlit, inedible, fixed in place, scenery, neuter, unmarked for special listing, ordinarily enumerated, unseen, unfamiliar, keywordless, used
printed name: "developers"
printed plural name: "backdrops"
indefinite article: none
description: "A loud buzzing sound breaks the quiet and is quickly followed up by laughter and cheering. You turn to see that a small crowd of people are huddled around an arduino board, which has been connected up to some sort of contraption. You overhear one of the crowd saying "Quick, tweet it again!". You turn back to what you are doing as the buzzer goes off for the second time."
initial appearance: none
keyword: none
sound: "silence"
smell: "nothing"

>s
Corridor - Westmost
BASECAMP CORRIDOR.

Exits: east and north to Basecamp.

>e
Corridor - West
corridor west.

Exits: east, west to Corridor - Westmost and south.

>e
Corridor - Middle
REGISTRATION DESK CORRIDOR.

You can see a helpful woman here.

Exits: east, west to Corridor - West, north, southeast and southwest.

>se
You need to register before you get too distracted by what is going on!

>ask about lanyard
(addressing the helpful woman)
You greet the woman behind the registration desk.

"Hello! What is it you need?" she asks while sorting various items on the desk. 
She runs her finger along the badges, looking for yours.

"Ah, here we go!" she exclaims. "This is your name, isn't it?" She holds the lanyard up for you to see. You nod and she hands it over to you. "A lot of the event rooms are on this floor - rooms 3A to 3E run from west to east along this corridor. The Venue is on the 1st floor, through the Gallery bar and I know that you've already found the Basecamp. Enjoy the event!

You say goodbye and turn to leave but she stops you. "Sorry, forgot to tell you something. We're just waiting on some more WiFi codes to be printed up, in case you wonder why you don't have one! It will come in time"

>wear lanyard
Snazzy.

You hear part of a conversation but can't work out where it is coming from. "... after lunch. I'll see you at the Computer vision session then? It'll b..." The conversation gets lost in the noise.

>ask about lanyard
She looks at the your lanyard. "It suits you!"

I beg your pardon?

>se
3C
3C DESCRIPTION.

Exits: northwest to Corridor - Middle.

>nw
Corridor - Middle
REGISTRATION DESK CORRIDOR.

You can see a helpful woman here.

Exits: east, west to Corridor - West, north, southeast to 3C and southwest.

"Watch out!" shouts a voice behind you. You turn and push yourself against the wall as someone rushes past you, holding a handful of flipcharts, a bag of pens and other bits and pieces. He drags several power strips behind him. He disappears out of sight.

>sw
3D
3D DESCRIPTION.

You can see Graham Klyne, a large project desk, an electronics desk, a small project desk (on which is a whirring laptop), and Ben O'Steen here.

Exits: northeast to Corridor - Middle.

>x developers
You peer over the shoulder of a particularly busy developer and catch a glimpse of a some sort of data visualisation she's been working on. You make a note to talk to her about it later on.

I beg your pardon?

>x chairs
You see a number of chairs here, some occupied, some not. You decide that now isn't the best time to take a seat.

>abstract me to Corridor - Middle
[Abstracted.]

>topics
You aren't talking to anyone right now.

>hi
(addressing the helpful woman)
You greet the woman behind the registration desk.

"Hello! What is it you need?" she asks while sorting various items on the desk. 
(You could ask her about WiFi or the Dev8D lanyard.)

>a wifi
You ask her about the Wifi code.

She begins to explain how you just need to wait a little longer, when she notices the disconnection anxiety writ large across your face. "If you are in a real hurry to get online, you could talk to Dave Tarrant and see if he is willing to do you a favour. He's downstairs in the Venue setting up a few things. Just don't tell him I sent you!"

* * *

>abstract me to 3D
[Abstracted.]

>look
3D
In 3D you can see Graham Klyne, a large project desk, an electronics desk, a small project desk (on which is a whirring laptop), and Ben O'Steen.

Exits: north.

>hi Ben
I only understood you as far as wanting to hi.

>hi
(addressing Ben O'Steen)
You greet Ben O'Steen.  "Hi!"

"Hello!  What do you want to talk about?"

(You could ask him about Programming languages.)

>ask him about languages
You remember back to the orientation talk. "I'm not sure what language I should go for at lunch. What do you think?" you ask.

He shrugs his shoulders a little. "To be honest, they are all pretty much the same. Pick one, learn it by writing actual code and most importantly, find out about the libraries you should use and more importantly, the libraries you shouldn't. The best way you can do that is by chatting with your peers - you know, the people like you, doing similar things to you. You can learn the most from them."

He turns back to his laptop and opens yet another terminal on the screen - you could've sworn you heard the laptop's fans sigh audibly. He brings up a python prompt and turns back to you. 

"I have to say though, I have a real soft spot for python. Does the job, clear, easy, nice. Well worth putting time in learning. There's also javascript, which is a crucial language to know if you are building a web service."

(You could ask him about Python, Javascript, or Programming languages.)

* * *

>a python
You ask "So... if I wanted to learn about python and its libraries and stuff...?"

"Google it" he replies with a smile. He continues to type into one of the many terminal windows on his screen.

Wow. That was pretty harsh. "Er... okay, whatever." you reply. You had thought he would help a little more than that. You turn to leave.

"Wait! I'm kidding!" he says. "Ordinarily I'd tell you to search for that online, as you'll find some of the best material there, like "Dive into Python", but look around you. There's a ton of collective python experience here, the kind of experience that make the difference between searching for hours or having an issue sorted out with a quick chat." He "alt-tab's back to a browser window. "In fact, I think there is a python workshop due to start soon if you are keen. It's taking place next door in room 3B. Just remember, it's the community of people that makes a language great, not the other way around. Ask questions, get involved. As with anything, you get out from it more than what you put it, but you have to put something in first!"

>abstract me to ULU Entrance
[Abstracted.]

>n
Ground floor stairs
In the low-light of the stairwell, you see a set of sharp-angled stairs spiralling upwards, fenced in by a utilitarian handrail, supported by thin banisters. The parts of the walls you can see are the kind of beige colour that cannot be described accurately without the words "institutional" and "depressing". It won't be how the colour is officially labelled, but labels are rarely honest. The noise from the rest of the building provides a background hum of activity. 

The only way is UP! (or something like that.) 

There is a message board lining the walls of the stairwell.

Exits: up and south to ULU Entrance.

>x message board
A number of panels of dark gray message board, covered with miscellaneous student posters about society events, music parties, and sports. There are a few odd posters stuck up here too, you notice a poster sporting what looks like 8-bit Zelda graphics.

>x zelda
The sheet is a scene from the very first Zelda game. Above an old man who is standing between two bright red blocky fires is text that reads: "It is dangerous to go alone. Take this!". The bottom of the sheet has been cut into little strips that you can pull off. Printed onto each is an orange sword, the master sword from the game. 

Neat.

>pull strip
Even though It's not that dangerous to go alone, you tear the strip from the bottom of the poster. 

Scaredy cat.

>undo
Ground floor stairs
[Previous turn undone.]

>tear strip
Even though It's not that dangerous to go alone, you tear the strip from the bottom of the poster. 

Scaredy cat.

>in
You can't go that way.

>i
You are carrying:
  a master sword paper strip
  Inspirations (empty)
  a phone

>x phone
You close the cached map directions to the venue as you won't be needing them anymore. No new emails, tweets, SMSs, IMs or pokes. No signal bars either, which would explain that.

>abstract me to Corridor - Westmost
[Abstracted.]

>n
Basecamp
You enter the door and come face-to-face (well, face-to-back) with a crowd of people, all of whom are looking intently towards the other side of the room.

You can see Mahendra Mahey here.

Exits: south.

It seems that things are just about to start, so you press forward to get a decent enough view. You manoeuvre through the throng of developers, hackers, academics and other delegates as politely as you can until you manage to get a view of the organiser who is just about to speak.

"Welcome! Thank you all for coming to this, the fourth Dev8D! The fourth! There are a lot of new faces out there which is excellent, great to see and I also see many people I've met before, which is doubly excellent! Helping people meet up and talk about the things that interest or even stump you is one of the key reasons this event exists. Many of you work in small teams and can feel isolated. Sometimes you alone are the team!"

You hear quite a few knowing laughs from the people in the crowd. Seems you aren't alone here after all. (Maybe you should put that master sword back where you found it, eh?).

>z
Time passes.

He continues: "

>z
Time passes.

If you haven't yet registered and picked up your Dev8D lanyard, please do so as soon as you can - it has your name on it!

Basecamp
Normal BASECAMP DESC.

You can see a refreshments table (on which are coffee, tea, a snack buffet, and a strange code fragment), a Schedule board, and Mahendra Mahey here.

Exits: south.

>x mahey
A harrassed-looking man, tall, his short dark hair flecked with grey. He is in constant motion around the room, checking and rechecking everything around him, seeing whether everyone is having a good time, making sure that the right posters are on the wall and that everyone has power and wifi.

Mahendra Mahey consults his phone and a look of panic crosses his face. He quickly heads to Corridor - Westmost.

>z
Time passes.

You see Mahendra Mahey enter Basecamp, with a steely determination in his eye to fix something in this room. What that is, you can't tell. Perhaps he can't yet either, but still.

>s
Corridor - Westmost
This part of the corridor narrows slightly and snakes around a corner where it ends. The set of double doors to the north lead to the Basecamp.

Exits: south and north to Basecamp.

You see Mahendra Mahey enter Corridor - Westmost, looking quite flustered.

>s
Corridor - West
You walk on, towards the noise. You can see that the corridor continues north, before turning west again. The entrance to room 3E is to the south.

Exits: east, north to Corridor - Westmost and south.

You see Mahendra Mahey enter Corridor - West.

>z
Time passes.

Mahendra Mahey Mahendra stops for a moment, eyes askance, trying to remember something. A look of dismay crosses his face and he sighs, before walking to Corridor - Westmost.

>s
You need to register before you get too distracted by what is going on!

>e
Corridor - Middle
You turn left into a small open area alongside a beige-coloured corridor, the same disappointing shade as that used in the stairwell. There is a busy woman sat behind a cluttered desk. To the south you can see the doors to rooms 3C and 3D.  The corridor continues east towards a set of closed doors, and west, towards what sounds like the rest of the conference.

You can see a busy woman here.

Exits: east, west to Corridor - West, north, southeast and southwest.

>hi
(addressing the busy woman)
You greet the woman behind the registration desk.

"Hello! What is it you need?" she asks while sorting various items on the desk.
.

(You could ask her about the Dev8D lanyard.)

>a lanyard
She runs her finger along the badges, looking for yours.

"Ah, here we go!" she exclaims. "This is your name, isn't it?" She holds the lanyard up for you to see. You nod and she hands it over to you. "A lot of the event rooms are on this floor - rooms 3A to 3E run from west to east along this corridor. The Venue is on the 1st floor, through the Gallery bar and I know that you've already found the Basecamp. Enjoy the event!

You say goodbye and turn to leave but she stops you. "Sorry, forgot to tell you something. We're just waiting on some more WiFi codes to be printed up, in case you wonder why you don't have one! It will come in time"

You try to remain calm, forcing yourself not to panic. You note with some horror that your phone can barely pick up Edge inside the building. Edge! A pair of paper cups and some string provides better connectivity than that!

You see Mahendra Mahey enter Corridor - Middle, looking quite flustered.

* * *

>smell
You inhale deeply. You can make out a few scents coming from the direction of the the red fish and the shiny red keycard.

>smell fish
Awful. Just... awful. And now you have got glitter on your cheek. Congratulations..

>smell card
You try to smell the keycard, but it's too close to the rotting fish for you to smell anything else. It probably smells like its owner's wallet anyhow. 

Well, it did until it was pushed underneath that fish.

>smell keycard
You try to smell the keycard, but it's too close to the rotting fish for you to smell anything else. It probably smells like its owner's wallet anyhow. 

Well, it did until it was pushed underneath that fish.

* * *

>x toy figures
On closer inspection, you see that these are geek figurines, not toys. The (only) difference between the two is that the first one costs ten times as much. You see a smiling green orc holding a pig, a small US-style mailbox on a stand, a blond, wimpy-looking pirate, a strange purple tentacle with arm flaps on its side... somehow, you feel that these figures don't all relate to text adventures. Some of them ever look home-made - that pig is glued crudely to the side of its orc, who has been given a tippex-painted smile.

* * *

>x phone
You look down at your phone. No new emails, tweets, SMSs, IMs or pokes. No signal bars either, which would explain that.

>x phone
No signal. No connectivity.

>x phone
Nothing. No signal either.

>x phone
No signal. No connectivity.

>drop phone
What are you? Mad? You'd no sooner lop off one of your arms than leave your phone out for someone to take. Your life is on that phone!.

>drop phone
What are you? Mad? You'd no sooner lop off one of your arms than leave your phone out for someone to take. Your life is on that phone!.

* * *

>showme the current scene
There seems to be no such object anywhere in the model world.

>scene
That noun did not make sense in this context.

>showme Getting Ready
There seems to be no such object anywhere in the model world.

>scenes
Scene 'Entire Game' playing (for 0 mins now)
Scene 'Getting Ready' playing (for 0 mins now)
(Scene monitoring now switched on. Type "scenes off" to switch it off again.)

>n
Ground floor stairs
In the low-light of the stairwell, you see a set of sharp-angled stairs spiralling upwards, fenced in by a utilitarian handrail, supported by thin banisters. The parts of the walls you can see are the kind of beige colour that cannot be described accurately without the words "institutional" and "depressing". It won't be how the colour is officially labelled, but labels are rarely honest. The noise from the rest of the building provides a background hum of activity. 

The only way is UP! (or something like that.) 

There is a message board lining the walls of the stairwell.

Exits: up and south to ULU Entrance.

* * *

>u
Third floor stairs
A spiralling staircase, hemmed in by harsh railings and beige walls. The noise from the rest of the building provides a background hum of activity.

Exits: south and down to First floor stairs.

>s
Corridor - Middle
You turn left into a small open area alongside a beige-coloured corridor, the same disappointing shade as that used in the stairwell. There is a busy woman sat behind a cluttered desk. To the south you can see the doors to rooms 3C and 3D.  The corridor continues east towards a set of closed doors, and west, towards what sounds like the rest of the conference.

You can see a busy woman here.

Exits: east, west, north to Third floor stairs, southeast and southwest.

You can hear a murmur coming from the west. It sounds like everyone is down that way You'd better hurry.

A small group of students, talking loudly, pass by you on their way to the stairs.

>z
Time passes.

>z
Time passes.

You hear a lull in the background chatter.

[Scene 'Orientation Talk' begins]
[Scene 'Getting Ready' ends]

>z
Time passes.

>scene
That noun did not make sense in this context.

>scenes
Scene 'Entire Game' playing (for 11 mins now)
Scene 'Getting Ready' ended
Scene 'Orientation Talk' playing (for 1 mins now)
(Scene monitoring now switched on. Type "scenes off" to switch it off again.)

>w
You should listen for a little while. It's only polite after all. (Type "wait" or "z" to skip on through the speech.)